Date,Cases,Deaths,Daily cases,Daily deaths,Active cases (new),Active cases (old),Change in active cases,Recoveries (old),Recoveries (new)
2020-02-15,16,0,,,9,9,0,7,7
2020-02-16,16,0,0,0,9,9,0,7,7
2020-02-17,16,0,0,0,9,9,0,7,7
2020-02-18,16,0,0,0,9,9,0,7,7
2020-02-19,16,0,0,0,2,2,0,14,14
2020-02-20,16,0,0,0,2,2,0,14,14
2020-02-21,16,0,0,0,1,1,0,15,15
2020-02-22,16,0,0,0,1,1,0,15,15
2020-02-23,16,0,0,0,1,1,0,15,15
2020-02-24,16,0,0,0,1,1,0,15,15
2020-02-25,16,0,0,0,0,0,0,16,16
2020-02-26,16,0,0,0,0,0,0,16,16
2020-02-27,16,0,0,0,0,0,0,16,16
2020-02-28,16,0,0,0,0,0,0,16,16
2020-02-29,16,0,0,0,0,0,0,16,16
2020-03-01,16,0,0,0,0,0,0,16,16
2020-03-02,16,0,0,0,0,0,0,16,16
2020-03-03,16,0,0,0,0,0,0,16,16
2020-03-04,16,0,0,0,0,0,0,16,16
2020-03-05,16,0,0,0,0,0,0,16,16
2020-03-06,17,0,1,0,1,1,0,16,16
2020-03-07,20,0,3,0,4,4,0,16,16
2020-03-08,31,0,11,0,14,15,-1,16,17
2020-03-09,32,0,1,0,15,16,-1,16,17
2020-03-10,35,0,3,0,18,19,-1,16,17
2020-03-11,40,0,5,0,23,24,-1,16,17
2020-03-12,45,0,5,0,28,29,-1,16,17
2020-03-13,45,0,0,0,28,29,-1,16,17
2020-03-14,54,0,9,0,37,38,-1,16,17
2020-03-15,58,0,4,0,41,42,-1,16,17
2020-03-16,62,0,4,0,45,46,-1,16,17
2020-03-17,67,0,5,0,50,51,-1,16,17
2020-03-18,78,0,11,0,60,62,-2,16,18
2020-03-19,87,0,9,0,69,71,-2,16,18
2020-03-20,93,0,6,0,74,76,-2,17,19
2020-03-21,96,0,3,0,77,79,-2,17,19
2020-03-22,119,0,23,0,96,102,-6,17,23
2020-03-23,130,0,11,0,106,113,-7,17,24
2020-03-24,142,0,12,0,117,125,-8,17,25
2020-03-25,159,0,17,0,131,142,-11,17,28
2020-03-26,164,0,5,0,133,144,-11,20,31
2020-03-27,175,0,11,0,143,155,-12,20,32
2020-03-28,187,0,12,0,153,166,-13,21,34
2020-03-29,212,0,25,0,169,187,-18,25,43
2020-03-30,223,0,11,0,149,168,-19,55,74
2020-03-31,231,0,8,0,154,173,-19,58,77
2020-04-01,237,0,6,0,155,174,-19,63,82
2020-04-02,255,0,18,0,158,180,-22,75,97
2020-04-03,261,0,6,0,154,176,-22,85,107
2020-04-04,262,0,1,0,150,172,-22,90,112
2020-04-05,263,0,1,0,151,173,-22,90,112
2020-04-06,267,0,4,0,150,172,-22,95,117
2020-04-07,273,0,6,0,128,150,-22,123,145
2020-04-08,273,0,0,0,125,147,-22,126,148
2020-04-09,277,0,4,0,127,149,-22,128,150
2020-04-10,279,0,2,0,113,135,-22,144,166
2020-04-11,280,0,1,0,114,136,-22,144,166
2020-04-12,284,0,4,0,118,140,-22,144,166
2020-04-13,287,0,3,0,119,141,-22,146,168
2020-04-14,288,0,1,0,97,119,-22,169,191
2020-04-15,290,0,2,0,97,119,-22,171,193
2020-04-16,290,0,0,0,91,113,-22,177,199
2020-04-17,290,0,0,0,70,92,-22,198,220
2020-04-18,290,0,0,0,67,89,-22,201,223
2020-04-19,290,0,0,0,66,88,-22,202,224
2020-04-20,290,0,0,0,54,76,-22,214,236
2020-04-21,290,0,0,0,52,74,-22,216,238
2020-04-22,290,0,0,0,45,74,-29,216,245
2020-04-23,290,0,0,0,44,74,-30,216,246
2020-04-24,292,0,2,0,50,72,-22,220,242
2020-04-25,292,0,0,0,45,72,-27,220,247
2020-04-26,292,0,0,0,45,72,-27,220,247
2020-04-27,292,0,0,0,45,72,-27,220,247
2020-04-28,292,0,0,0,45,72,-27,220,247
2020-04-29,292,0,0,0,48,70,-22,222,244
2020-04-30,292,0,0,0,51,70,-19,222,241
2020-05-01,292,0,0,0,51,70,-19,222,241
2020-05-02,292,0,0,0,51,70,-19,222,241
2020-05-03,293,0,1,0,52,71,-19,222,241
2020-05-04,293,0,0,0,52,71,-19,222,241
2020-05-05,293,0,0,0,39,61,-22,232,254
2020-05-06,293,0,0,0,39,61,-22,232,254
2020-05-07,313,0,20,0,55,80,-25,233,258
2020-05-08,313,0,0,0,47,72,-25,241,266
2020-05-09,313,0,0,0,47,72,-25,241,266
2020-05-10,313,0,0,0,47,72,-25,241,266
2020-05-11,313,0,0,0,39,64,-25,249,274
2020-05-12,313,0,0,0,36,61,-25,252,277
2020-05-13,313,0,0,0,36,61,-25,252,277
2020-05-14,344,0,31,0,52,84,-32,260,292
2020-05-15,346,0,2,0,54,86,-32,260,292
2020-05-16,350,0,4,0,58,90,-32,260,292
2020-05-17,352,0,2,0,60,92,-32,260,292
2020-05-18,356,0,4,0,61,93,-32,263,295
2020-05-19,356,0,0,0,61,93,-32,263,295
2020-05-20,356,0,0,0,61,93,-32,263,295
2020-05-21,356,0,0,0,60,92,-32,264,296
2020-05-22,356,0,0,0,57,89,-32,267,299
2020-05-23,356,0,0,0,57,89,-32,267,299
2020-05-24,357,0,1,0,58,90,-32,267,299
2020-05-25,358,0,1,0,54,86,-32,272,304
2020-05-26,359,0,1,0,55,87,-32,272,304
2020-05-27,359,0,0,0,49,81,-32,278,310
2020-05-28,359,0,0,0,49,81,-32,278,310
2020-05-29,359,0,0,0,48,80,-32,279,311
2020-05-30,360,0,1,0,49,81,-32,279,311
2020-05-31,360,0,0,0,49,81,-32,279,311
2020-06-01,360,0,0,0,35,67,-32,293,325
2020-06-02,360,0,0,0,30,62,-32,298,330
2020-06-03,360,0,0,0,26,58,-32,302,334
2020-06-04,360,0,0,0,26,58,-32,302,334
2020-06-05,360,0,0,0,21,53,-32,307,339
2020-06-06,361,0,1,0,22,54,-32,307,339
2020-06-07,361,0,0,0,22,54,-32,307,339
2020-06-08,364,0,3,0,16,48,-32,316,348
2020-06-09,364,0,0,0,16,48,-32,316,348
2020-06-10,364,0,0,0,12,44,-32,320,352
2020-06-11,364,0,0,0,11,43,-32,321,353
2020-06-12,365,0,1,0,10,42,-32,323,355
2020-06-13,366,0,1,0,11,43,-32,323,355
2020-06-14,366,0,0,0,11,43,-32,323,355
2020-06-15,366,0,0,0,11,43,-32,323,355
2020-06-16,366,0,0,0,9,41,-32,325,357
2020-06-17,367,0,1,0,10,42,-32,325,357
2020-06-18,374,0,7,0,17,49,-32,325,357
2020-06-19,381,0,7,0,23,55,-32,326,358
2020-06-20,381,0,0,0,22,54,-32,327,359
2020-06-21,381,0,0,0,22,54,-32,327,359
2020-06-22,381,0,0,0,21,53,-32,328,360
2020-06-23,381,0,0,0,20,52,-32,329,361
2020-06-24,384,0,3,0,23,55,-32,329,361
2020-06-25,384,0,0,0,23,55,-32,329,361
2020-06-26,385,0,1,0,23,55,-32,330,362
2020-06-27,387,0,2,0,25,57,-32,330,362
2020-06-28,387,0,0,0,25,57,-32,330,362
2020-06-29,387,0,0,0,20,52,-32,335,367
2020-06-30,387,0,0,0,20,52,-32,335,367
2020-07-01,387,0,0,0,19,51,-32,336,368
2020-07-02,387,0,0,0,15,47,-32,340,372
2020-07-03,387,0,0,0,15,47,-32,340,372
2020-07-04,387,0,0,0,15,47,-32,340,372
2020-07-05,387,0,0,0,15,47,-32,340,372
2020-07-06,404,0,17,0,28,63,-35,341,376
2020-07-07,404,0,0,0,27,62,-35,342,377
2020-07-08,404,0,0,0,22,57,-35,347,382
2020-07-09,404,0,0,0,22,57,-35,347,382
2020-07-10,404,0,0,0,19,54,-35,350,385
2020-07-11,405,0,1,0,20,55,-35,350,385
2020-07-12,407,0,2,0,22,57,-35,350,385
2020-07-13,407,0,0,0,22,57,-35,350,385
2020-07-14,408,0,1,0,21,56,-35,352,387
2020-07-15,416,0,8,0,28,63,-35,353,388
2020-07-16,416,0,0,0,25,60,-35,356,391
2020-07-17,417,0,1,0,26,61,-35,356,391
2020-07-18,417,0,0,0,25,60,-35,357,392
2020-07-19,418,0,1,0,26,61,-35,357,392
2020-07-20,419,0,1,0,24,59,-35,360,395
2020-07-21,439,0,20,0,36,74,-38,365,403
2020-07-22,446,0,7,0,43,81,-38,365,403
2020-07-23,450,0,4,0,47,85,-38,365,403
2020-07-24,451,0,1,0,48,86,-38,365,403
2020-07-25,455,0,4,0,52,90,-38,365,403
2020-07-26,458,0,3,0,55,93,-38,365,403
2020-07-27,470,0,12,0,66,105,-39,365,404
2020-07-28,488,0,18,0,77,119,-42,369,411
2020-07-29,504,0,16,0,90,135,-45,369,414
2020-07-30,578,0,74,0,140,209,-69,369,438
2020-07-31,631,2,53,2,171,256,-85,373,458
2020-08-01,697,3,66,1,214,321,-107,373,480
2020-08-02,738,6,41,3,241,359,-118,373,491
2020-08-03,784,6,46,0,272,404,-132,374,506
2020-08-04,809,8,25,2,286,423,-137,378,515
2020-08-05,877,8,68,0,328,488,-160,381,541
2020-08-06,918,10,41,2,345,516,-171,392,563
2020-08-07,981,10,63,0,384,576,-192,395,587
2020-08-08,1011,10,30,0,407,606,-199,395,594
2020-08-09,1051,11,40,1,435,645,-210,395,605
2020-08-10,1057,15,6,4,433,643,-210,399,609
2020-08-11,1080,16,23,1,451,665,-214,399,613
2020-08-12,1100,17,20,1,457,674,-217,409,626
2020-08-13,1139,21,39,4,465,693,-228,425,653
2020-08-14,1162,22,23,1,471,703,-232,437,669
2020-08-15,1188,23,26,1,481,718,-237,447,684
2020-08-16,1200,24,12,1,482,720,-238,456,694
2020-08-17,1226,24,26,0,492,735,-243,467,710
2020-08-18,1232,25,6,1,438,681,-243,526,769
2020-08-19,1237,25,5,0,436,679,-243,533,776
2020-08-20,1253,25,16,0,440,686,-246,542,788
2020-08-21,1255,25,2,0,439,685,-246,545,791
2020-08-22,1260,26,5,1,425,671,-246,563,809
2020-08-23,1262,27,2,1,426,672,-246,563,809
2020-08-24,1268,27,6,0,408,654,-246,587,833
2020-08-25,1275,27,7,0,410,656,-246,592,838
2020-08-26,1280,29,5,2,373,619,-246,632,878
2020-08-27,1282,30,2,1,369,615,-246,637,883
2020-08-28,1284,30,2,0,345,591,-246,663,909
2020-08-29,1286,32,2,2,331,577,-246,677,923
2020-08-30,1286,32,0,0,313,559,-246,695,941
2020-08-31,1290,34,4,2,303,549,-246,707,953
2020-09-01,1290,34,0,0,275,521,-246,735,981
2020-09-02,1292,34,2,0,266,512,-246,746,992
2020-09-03,1292,35,0,1,256,502,-246,755,1001
2020-09-04,1295,35,3,0,242,488,-246,772,1018
2020-09-05,1295,35,0,0,209,455,-246,805,1051
2020-09-06,1295,35,0,0,199,445,-246,815,1061
2020-09-07,1295,35,0,0,161,407,-246,853,1099
2020-09-08,1300,35,5,0,151,397,-246,868,1114
2020-09-09,1305,35,5,0,134,380,-246,890,1136
2020-09-10,1305,35,0,0,131,377,-246,893,1139
2020-09-11,1306,35,1,0,123,369,-246,902,1148
2020-09-12,1306,35,0,0,115,361,-246,910,1156
2020-09-13,1309,35,3,0,110,356,-246,918,1164
2020-09-14,1309,35,0,0,102,348,-246,926,1172
2020-09-15,1309,35,0,0,97,343,-246,931,1177
2020-09-16,1309,35,0,0,92,338,-246,936,1182
2020-09-17,1312,35,3,0,91,337,-246,940,1186
2020-09-18,1314,35,2,0,92,338,-246,941,1187
2020-09-19,1314,35,0,0,91,337,-246,942,1188
2020-09-20,1314,35,0,0,91,337,-246,942,1188
2020-09-21,1314,35,0,0,86,332,-246,947,1193
2020-09-22,1314,35,0,0,76,322,-246,957,1203
2020-09-23,1315,35,1,0,43,289,-246,991,1237
2020-09-24,1315,35,0,0,43,289,-246,991,1237
2020-09-25,1315,35,0,0,35,281,-246,999,1245
2020-09-26,1315,35,0,0,35,281,-246,999,1245
2020-09-27,1320,35,5,0,40,286,-246,999,1245
2020-09-28,1323,35,3,0,43,289,-246,999,1245
2020-09-29,1343,35,20,0,52,301,-249,1007,1256
2020-09-30,1343,35,0,0,49,298,-249,1010,1259
2020-10-01,1344,35,1,0,50,299,-249,1010,1259
2020-10-02,1345,35,1,0,41,290,-249,1020,1269
2020-10-03,1345,35,0,0,41,290,-249,1020,1269
2020-10-04,1345,35,0,0,41,290,-249,1020,1269
2020-10-05,1346,35,1,0,40,289,-249,1022,1271
2020-10-06,1347,35,1,0,40,289,-249,1023,1272
2020-10-07,1348,35,1,0,41,290,-249,1023,1272
2020-10-08,1349,35,1,0,42,291,-249,1023,1272
2020-10-09,1354,35,5,0,46,295,-249,1024,1273
2020-10-10,1356,35,2,0,48,297,-249,1024,1273
2020-10-11,1358,35,2,0,50,299,-249,1024,1273
2020-10-12,1359,35,1,0,50,299,-249,1025,1274
2020-10-13,1362,35,3,0,53,302,-249,1025,1274
2020-10-14,1371,35,9,0,58,307,-249,1029,1278
2020-10-15,1373,35,2,0,59,308,-249,1030,1279
2020-10-16,1373,35,0,0,58,307,-249,1031,1280
2020-10-17,1375,35,2,0,60,309,-249,1031,1280
2020-10-18,1383,35,8,0,68,317,-249,1031,1280
2020-10-19,1389,35,6,0,59,308,-249,1046,1295
2020-10-20,1390,35,1,0,60,309,-249,1046,1295
2020-10-21,1393,35,3,0,63,312,-249,1046,1295
2020-10-22,1397,35,4,0,64,313,-249,1049,1298
2020-10-23,1397,35,0,0,64,313,-249,1049,1298
2020-10-24,1410,35,13,0,74,324,-250,1051,1301
2020-10-25,1418,35,8,0,76,326,-250,1057,1307
2020-10-26,1419,35,1,0,73,323,-250,1061,1311
2020-10-27,1422,35,3,0,75,325,-250,1062,1312
2020-10-28,1423,35,1,0,76,326,-250,1062,1312
2020-10-29,1427,35,4,0,80,330,-250,1062,1312
2020-10-30,1427,35,0,0,80,330,-250,1062,1312
2020-10-31,1430,35,3,0,83,333,-250,1062,1312
2020-11-01,1430,35,0,0,82,332,-250,1063,1313
2020-11-02,1443,35,13,0,92,343,-251,1065,1316
2020-11-03,1454,35,11,0,98,350,-252,1069,1321
2020-11-04,1455,35,1,0,99,351,-252,1069,1321
2020-11-05,1459,35,4,0,103,355,-252,1069,1321
2020-11-06,1464,35,5,0,107,359,-252,1070,1322
2020-11-07,1465,35,1,0,108,360,-252,1070,1322
2020-11-08,1465,35,0,0,108,360,-252,1070,1322
2020-11-09,1467,35,2,0,93,345,-252,1087,1339
2020-11-10,1479,35,12,0,104,357,-253,1087,1340
2020-11-11,1512,35,33,0,130,390,-260,1087,1347
2020-11-12,1513,35,1,0,125,385,-260,1093,1353
2020-11-13,1516,35,3,0,120,380,-260,1101,1361
2020-11-14,1516,35,0,0,118,378,-260,1103,1363
2020-11-15,1548,35,32,0,143,410,-267,1103,1370
2020-11-16,1550,35,2,0,124,391,-267,1124,1391
2020-11-17,1555,35,5,0,129,396,-267,1124,1391
2020-11-18,1568,35,13,0,141,409,-268,1124,1392
2020-11-19,1572,35,4,0,127,395,-268,1142,1410
2020-11-20,1573,35,1,0,128,396,-268,1142,1410
2020-11-21,1574,35,1,0,129,397,-268,1142,1410
2020-11-22,1575,35,1,0,130,398,-268,1142,1410
2020-11-23,1580,35,5,0,126,394,-268,1151,1419
2020-11-24,1584,35,4,0,128,396,-268,1153,1421
2020-11-25,1589,35,5,0,133,401,-268,1153,1421
2020-11-26,1600,35,11,0,130,399,-269,1166,1435
2020-11-27,1608,35,8,0,134,403,-269,1170,1439
2020-11-28,1610,35,2,0,127,396,-269,1179,1448
2020-11-29,1612,35,2,0,129,398,-269,1179,1448
2020-11-30,1616,35,4,0,133,402,-269,1179,1448
2020-12-01,1620,35,4,0,121,390,-269,1195,1464
2020-12-02,1627,35,7,0,122,391,-269,1201,1470
2020-12-03,1630,35,3,0,117,386,-269,1209,1478
2020-12-04,1630,35,0,0,106,375,-269,1220,1489
2020-12-05,1634,35,4,0,110,379,-269,1220,1489
2020-12-06,1635,35,1,0,111,380,-269,1220,1489
2020-12-07,1636,35,1,0,108,377,-269,1224,1493
2020-12-08,1647,35,11,0,118,388,-270,1224,1494
2020-12-09,1651,35,4,0,121,391,-270,1225,1495
2020-12-10,1655,35,4,0,125,395,-270,1225,1495
2020-12-11,1661,35,6,0,118,388,-270,1238,1508
2020-12-12,1665,35,4,0,122,392,-270,1238,1508
2020-12-13,1667,35,2,0,121,391,-270,1241,1511
2020-12-14,1672,35,5,0,121,391,-270,1246,1516
2020-12-15,1675,35,3,0,118,388,-270,1252,1522
2020-12-16,1675,35,0,0,118,388,-270,1252,1522
2020-12-17,1677,35,2,0,109,379,-270,1263,1533
2020-12-18,1680,35,3,0,109,379,-270,1266,1536
2020-12-19,1681,35,1,0,107,377,-270,1269,1539
2020-12-20,1683,35,2,0,109,379,-270,1269,1539
2020-12-21,1684,35,1,0,110,380,-270,1269,1539
2020-12-22,1690,35,6,0,104,374,-270,1281,1551
2020-12-23,1691,35,1,0,105,375,-270,1281,1551
2020-12-24,1703,35,12,0,116,387,-271,1281,1552
2020-12-25,1710,35,7,0,101,372,-271,1303,1574
2020-12-26,1711,35,1,0,102,373,-271,1303,1574
2020-12-27,1712,35,1,0,103,374,-271,1303,1574
2020-12-28,1723,35,11,0,113,385,-272,1303,1575
2020-12-29,1726,35,3,0,100,372,-272,1319,1591
2020-12-30,1728,35,2,0,98,370,-272,1323,1595
2020-12-31,1737,35,9,0,105,377,-272,1325,1597
2021-01-01,1746,35,9,0,114,386,-272,1325,1597
2021-01-02,1754,35,8,0,110,382,-272,1337,1609
2021-01-03,1767,35,13,0,120,393,-273,1339,1612
2021-01-04,1770,35,3,0,123,396,-273,1339,1612
2021-01-05,1777,35,7,0,130,403,-273,1339,1612
2021-01-06,1778,35,1,0,117,390,-273,1353,1626
2021-01-07,1782,35,4,0,121,394,-273,1353,1626
2021-01-08,1785,35,3,0,120,393,-273,1357,1630
2021-01-09,1786,35,1,0,117,390,-273,1361,1634
2021-01-10,1787,35,1,0,118,391,-273,1361,1634
2021-01-11,1788,35,1,0,119,392,-273,1361,1634
2021-01-12,1793,35,5,0,124,397,-273,1361,1634
2021-01-13,1794,35,1,0,117,390,-273,1369,1642
2021-01-14,1805,35,11,0,127,401,-274,1369,1643
2021-01-15,1810,35,5,0,121,395,-274,1380,1654
2021-01-16,1811,35,1,0,122,396,-274,1380,1654
2021-01-17,1811,35,0,0,122,396,-274,1380,1654
2021-01-18,1813,35,2,0,102,376,-274,1402,1676
2021-01-19,1814,35,1,0,103,377,-274,1402,1676
2021-01-20,1818,35,4,0,103,377,-274,1406,1680
2021-01-21,1820,35,2,0,100,374,-274,1411,1685
2021-01-22,1822,35,2,0,102,376,-274,1411,1685
2021-01-23,1822,35,0,0,102,376,-274,1411,1685
2021-01-24,1822,35,0,0,102,376,-274,1411,1685
2021-01-25,1823,35,1,0,89,363,-274,1425,1699
2021-01-26,1825,35,2,0,86,360,-274,1430,1704
2021-01-27,1825,35,0,0,86,360,-274,1430,1704
2021-01-28,1972,35,147,0,177,507,-330,1430,1760
2021-01-29,2069,35,97,0,222,586,-364,1448,1812
2021-01-30,2165,35,96,0,276,674,-398,1456,1854
2021-01-31,2239,35,74,0,325,747,-422,1457,1879
2021-02-01,2287,35,48,0,355,792,-437,1460,1897
2021-02-02,2333,35,46,0,387,838,-451,1460,1911
2021-02-03,2373,35,40,0,415,877,-462,1461,1923
2021-02-04,2442,35,69,0,457,942,-485,1465,1950
2021-02-05,2465,35,23,0,476,965,-489,1465,1954
2021-02-06,2470,35,5,0,478,967,-489,1468,1957
2021-02-07,2495,35,25,0,494,988,-494,1472,1966
2021-02-08,2568,35,73,0,543,1061,-518,1472,1990
2021-02-09,2585,35,17,0,557,1078,-521,1472,1993
2021-02-10,2621,35,36,0,576,1106,-530,1480,2010
2021-02-11,2694,35,73,0,577,1131,-554,1528,2082
2021-02-12,2696,35,2,0,578,1132,-554,1529,2083
2021-02-13,2774,35,78,0,631,1210,-579,1529,2108
2021-02-14,2822,35,48,0,661,1255,-594,1532,2126
2021-02-15,2884,35,62,0,693,1308,-615,1541,2156
2021-02-16,2947,35,63,0,703,1339,-636,1573,2209
2021-02-17,2968,35,21,0,720,1359,-639,1574,2213
2021-02-18,2989,35,21,0,707,1349,-642,1605,2247
2021-02-19,3007,35,18,0,700,1345,-645,1627,2272
2021-02-20,3013,35,6,0,706,1351,-645,1627,2272
2021-02-21,3031,35,18,0,646,1294,-648,1702,2350
2021-02-22,3040,35,9,0,640,1288,-648,1717,2365
2021-02-23,3049,35,9,0,649,1297,-648,1717,2365
2021-02-24,3061,35,12,0,587,1236,-649,1790,2439
2021-02-25,3069,35,8,0,581,1230,-649,1804,2453
2021-02-26,3075,35,6,0,552,1201,-649,1839,2488
2021-02-27,3081,35,6,0,553,1202,-649,1844,2493
2021-02-28,3100,35,19,0,537,1189,-652,1876,2528
2021-03-01,3100,35,0,0,537,1189,-652,1876,2528
2021-03-02,3131,35,31,0,539,1198,-659,1898,2557
2021-03-03,3142,35,11,0,549,1209,-660,1898,2558
2021-03-04,3148,35,6,0,533,1193,-660,1920,2580
2021-03-05,3154,35,6,0,539,1199,-660,1920,2580
2021-03-06,3161,35,7,0,546,1206,-660,1920,2580
2021-03-07,3173,35,12,0,557,1218,-661,1920,2581
2021-03-08,3186,35,13,0,569,1231,-662,1920,2582
2021-03-09,3188,35,2,0,487,1149,-662,2004,2666
2021-03-10,3191,35,3,0,490,1152,-662,2004,2666
2021-03-11,3195,35,4,0,450,1112,-662,2048,2710
2021-03-12,3215,35,20,0,429,1094,-665,2086,2751
2021-03-13,3218,35,3,0,432,1097,-665,2086,2751
2021-03-14,3219,35,1,0,433,1098,-665,2086,2751
2021-03-15,3222,35,3,0,407,1072,-665,2115,2780
2021-03-16,3225,35,3,0,367,1032,-665,2158,2823
2021-03-17,3232,35,7,0,334,999,-665,2198,2863
2021-03-18,3235,35,3,0,337,1002,-665,2198,2863
2021-03-19,3236,35,1,0,338,1003,-665,2198,2863
2021-03-20,3237,35,1,0,339,1004,-665,2198,2863
2021-03-21,3237,35,0,0,339,1004,-665,2198,2863
2021-03-22,3240,35,3,0,307,972,-665,2233,2898
2021-03-23,3240,35,0,0,294,959,-665,2246,2911
2021-03-24,3241,35,1,0,276,941,-665,2265,2930
2021-03-25,3244,35,3,0,279,944,-665,2265,2930
2021-03-26,3251,35,7,0,286,951,-665,2265,2930
2021-03-27,3251,35,0,0,243,908,-665,2308,2973
2021-03-28,3256,35,5,0,248,913,-665,2308,2973
2021-03-29,3259,35,3,0,251,916,-665,2308,2973
2021-03-30,3259,35,0,0,200,865,-665,2359,3024
2021-03-31,3268,35,9,0,209,874,-665,2359,3024
2021-04-01,3285,35,17,0,223,891,-668,2359,3027
2021-04-02,3288,35,3,0,202,870,-668,2383,3051
2021-04-03,3294,35,6,0,208,876,-668,2383,3051
2021-04-04,3299,35,5,0,213,881,-668,2383,3051
2021-04-05,3305,35,6,0,186,854,-668,2416,3084
2021-04-06,3317,35,12,0,191,860,-669,2422,3091
2021-04-07,3329,35,12,0,195,865,-670,2429,3099
2021-04-08,3338,35,9,0,204,874,-670,2429,3099
2021-04-09,3356,35,18,0,219,892,-673,2429,3102
2021-04-10,3365,35,9,0,228,901,-673,2429,3102
2021-04-11,3366,35,1,0,229,902,-673,2429,3102
2021-04-12,3379,35,13,0,225,899,-674,2445,3119
2021-04-13,3388,35,9,0,234,908,-674,2445,3119
2021-04-14,3411,35,23,0,253,931,-678,2445,3123
2021-04-15,3443,35,32,0,278,963,-685,2445,3130
2021-04-16,3460,35,17,0,292,980,-688,2445,3133
2021-04-17,3469,35,9,0,271,959,-688,2475,3163
2021-04-18,3472,35,3,0,274,962,-688,2475,3163
2021-04-19,3479,35,7,0,281,969,-688,2475,3163
2021-04-20,3488,35,9,0,275,963,-688,2490,3178
2021-04-21,3494,35,6,0,281,969,-688,2490,3178
2021-04-22,3505,35,11,0,291,980,-689,2490,3179
2021-04-23,3522,35,17,0,305,997,-692,2490,3182
2021-04-24,3525,35,3,0,308,1000,-692,2490,3182
2021-04-25,3536,35,11,0,292,985,-693,2516,3209
2021-04-26,3545,35,9,0,301,994,-693,2516,3209
2021-04-27,3550,35,5,0,306,999,-693,2516,3209
2021-04-28,3558,35,8,0,314,1007,-693,2516,3209
2021-04-29,3626,35,68,0,359,1075,-716,2516,3232
2021-04-30,3647,35,21,0,377,1096,-719,2516,3235
2021-05-01,3664,35,17,0,359,1081,-722,2548,3270
2021-05-02,3689,35,25,0,378,1105,-727,2549,3276
2021-05-03,3712,35,23,0,386,1117,-731,2560,3291
2021-05-04,3730,35,18,0,401,1135,-734,2560,3294
2021-05-05,3763,35,33,0,427,1168,-741,2560,3301
2021-05-06,3870,35,107,0,495,1275,-780,2560,3340
2021-05-07,3941,35,71,0,542,1346,-804,2560,3364
2021-05-08,4091,35,150,0,603,1454,-851,2602,3453
2021-05-09,4259,35,168,0,765,1622,-857,2602,3459
2021-05-10,4475,35,216,0,970,1838,-868,2602,3470
2021-05-11,4598,35,123,0,1076,1945,-869,2618,3487
2021-05-12,4733,35,135,0,1208,2062,-854,2636,3490
2021-05-13,4869,35,136,0,1333,2177,-844,2657,3501
2021-05-14,5044,35,175,0,1499,2352,-853,2657,3510
2021-05-15,5322,36,278,1,1771,2618,-847,2668,3515
2021-05-16,5637,36,315,0,2079,2933,-854,2668,3522
2021-05-17,5940,37,303,1,2313,3235,-922,2668,3590
2021-05-18,6191,37,251,0,2544,3467,-923,2687,3610
2021-05-19,6481,37,290,0,2817,3757,-940,2687,3627
2021-05-20,6680,39,199,2,2989,3954,-965,2687,3652
2021-05-21,6901,41,221,2,3187,4171,-984,2689,3673
2021-05-22,7141,41,240,0,3411,4379,-968,2721,3689
2021-05-23,7361,42,220,1,3597,4598,-1001,2721,3722
2021-05-24,7672,44,311,2,3800,4834,-1034,2794,3828
2021-05-25,8276,44,604,0,4335,5438,-1103,2794,3897
2021-05-26,8792,45,516,1,4700,5894,-1194,2853,4047
2021-05-27,9171,46,379,1,4911,6272,-1361,2853,4214
2021-05-28,9584,47,413,1,5108,6641,-1533,2896,4429
2021-05-29,10053,47,469,0,5455,7110,-1655,2896,4551
2021-05-30,10460,47,407,0,5727,7463,-1736,2950,4686
2021-05-31,10815,47,355,0,5946,7739,-1793,3029,4822
2021-06-01,11222,48,407,1,6177,8131,-1954,3043,4997
2021-06-02,11615,49,393,1,6292,8481,-2189,3085,5274
2021-06-03,12020,49,405,0,6383,8886,-2503,3085,5588
2021-06-04,12392,51,372,2,6450,9099,-2649,3242,5891
2021-06-05,12805,53,413,2,6612,9442,-2830,3310,6140
2021-06-06,13146,53,341,0,6665,9725,-3060,3368,6428
2021-06-07,13533,53,387,0,6853,9971,-3118,3509,6627
2021-06-08,13817,55,284,2,6914,10215,-3301,3547,6848
2021-06-09,14488,55,671,0,7347,10797,-3450,3636,7086
2021-06-10,14853,55,365,0,7492,11090,-3598,3708,7306
2021-06-11,15178,57,325,2,7504,11317,-3813,3804,7617
2021-06-12,15605,58,427,1,7328,11720,-4392,3827,8219
2021-06-13,16091,59,486,1,7298,12034,-4736,3998,8734
2021-06-14,16540,59,449,0,7369,12245,-4876,4236,9112
2021-06-15,17205,61,665,2,7619,12605,-4986,4539,9525
2021-06-16,17901,61,696,0,7848,13250,-5402,4590,9992
2021-06-17,18748,61,847,0,8288,14034,-5746,4653,10399
2021-06-18,19180,62,432,1,8364,14385,-6021,4733,10754
2021-06-19,19976,64,796,2,8752,14858,-6106,5054,11160
2021-06-20,20489,66,513,2,8872,15194,-6322,5229,11551
2021-06-21,20938,69,449,3,8915,15416,-6501,5453,11954
2021-06-22,21334,69,396,0,8942,15719,-6777,5546,12323
2021-06-23,21700,70,366,1,8894,15946,-7052,5684,12736
2021-06-24,22168,72,468,2,9020,16337,-7317,5759,13076
2021-06-25,23595,74,1427,2,10060,17572,-7512,5949,13461
2021-06-26,23879,74,284,0,10062,17668,-7606,6137,13743
2021-06-27,24482,76,603,2,9992,18087,-8095,6319,14414
2021-06-28,25142,76,660,0,10289,18547,-8258,6519,14777
2021-06-29,25752,80,610,4,10570,18908,-8338,6764,15102
2021-06-30,26490,81,738,1,10884,19569,-8685,6840,15525
2021-07-01,27667,81,1177,0,11576,20339,-8763,7247,16010
2021-07-02,28562,84,895,3,12019,21083,-9064,7395,16459
2021-07-03,30081,84,1519,0,12876,22354,-9478,7643,17121
2021-07-04,31549,86,1468,2,13646,23644,-9998,7819,17817
2021-07-05,33361,90,1812,4,14609,25249,-10640,8022,18662
2021-07-06,35059,97,1698,7,15872,26885,-11013,8077,19090
2021-07-07,36716,102,1657,5,16735,28057,-11322,8557,19879
2021-07-08,38883,105,2167,3,18391,29828,-11437,8950,20387
2021-07-09,41562,110,2679,5,20619,32468,-11849,8984,20833
2021-07-10,44614,112,3052,2,23278,35298,-12020,9204,21224
2021-07-11,47833,119,3219,7,26126,38439,-12313,9275,21588
2021-07-12,51759,125,3926,6,29585,42303,-12718,9331,22049
2021-07-13,55553,132,3794,7,31951,45868,-13917,9553,23470
2021-07-14,60390,138,4837,6,36505,50628,-14123,9624,23747
2021-07-15,66025,207,5635,69,41474,56130,-14656,9688,24344
2021-07-16,71525,225,5500,18,46365,61280,-14915,10020,24935
2021-07-17,77651,225,6126,0,51899,67114,-15215,10312,25527
2021-07-18,87428,254,9777,29,60909,76507,-15598,10667,26265
2021-07-19,94350,334,6922,80,66603,82969,-16366,11047,27413
2021-07-20,102263,334,7913,0,73701,90486,-16785,11443,28228
2021-07-21,111104,370,8841,36,80987,98763,-17776,11971,29747
2021-07-22,121317,396,10213,26,89742,107500,-17758,13421,31179
2021-07-23,133371,428,12054,32,99978,117407,-17429,15536,32965
2021-07-24,148639,462,15268,34,113546,130594,-17048,17583,34631
2021-07-25,161066,493,12427,31,124319,141231,-16912,19342,36254
2021-07-26,174068,524,13002,31,135154,152200,-17046,21344,38390
2021-07-27,187121,524,13053,0,145559,163651,-18092,22946,41038
2021-07-28,197938,630,10817,106,153218,169851,-16633,27457,44090
2021-07-29,210459,863,12521,233,162393,177816,-15423,31780,47203
2021-07-30,224723,1162,14264,299,172665,188077,-15412,35484,50896
2021-07-31,238948,1307,14225,145,183250,198907,-15657,38734,54391
2021-08-01,253168,1499,14220,192,192586,208512,-15926,43157,59083
2021-08-02,265464,1696,12296,197,199242,216803,-17561,46965,64526
2021-08-03,279365,2073,13901,377,207463,226461,-18998,50831,69829
2021-08-04,291937,2330,12572,257,214029,235275,-21246,54332,75578
2021-08-05,303885,2724,11948,394,216063,243121,-27058,58040,85098
2021-08-06,317612,3021,13727,297,222965,252259,-29294,62332,91626
2021-08-07,329711,3255,12099,234,227214,259819,-32605,66637,99242
2021-08-08,345698,3402,15987,147,234447,270799,-36352,71497,107849
2021-08-09,361104,3763,15406,361,239426,281421,-41995,75920,117915
2021-08-10,374944,4152,13840,389,241184,290444,-49260,80348,129608
2021-08-11,389400,4495,14456,343,240418,299751,-59333,85154,144487
2021-08-12,405348,4822,15948,327,243955,311381,-67426,89145,156571
2021-08-13,420488,5098,15140,276,246144,322652,-76508,92738,169246
2021-08-14,436517,5448,16029,350,249046,334084,-85038,96985,182023
2021-08-15,452323,5786,15806,338,254047,344033,-89986,102504,192490
2021-08-16,466594,6154,14271,368,255767,353463,-97696,106977,204673
2021-08-17,482440,6486,15846,332,257385,364646,-107261,111308,218569
2021-08-18,496716,6785,14276,299,257469,374872,-117403,115059,232462
2021-08-19,514290,7166,17574,381,260741,387065,-126324,120059,246383
2021-08-20,535363,7557,21073,391,269508,394991,-125483,132815,258298
2021-08-21,554265,7926,18902,369,274531,406252,-131721,140087,271808
2021-08-22,572959,8296,18694,370,280652,416996,-136344,147667,284011
2021-08-23,589918,8686,16959,390,285643,426620,-140977,154612,295589
2021-08-24,607749,9035,17831,349,289788,436439,-146651,162275,308926
2021-08-25,627701,9371,19952,336,297654,448409,-150755,169921,320676
2021-08-26,654233,9690,26532,319,308216,456055,-147839,188488,336327
2021-08-27,675549,10077,21316,387,314058,466858,-152800,198614,351414
2021-08-28,695513,10430,19964,353,320216,474094,-153878,210989,364867
2021-08-29,716625,10775,21112,345,326880,486048,-159168,219802,378970
2021-08-30,740085,11091,23460,316,334421,500178,-165757,228816,394573
2021-08-31,760882,11456,20797,365,340029,510566,-170537,238860,409397
2021-09-01,779744,11896,18862,440,342787,519126,-176339,248722,425061
2021-09-02,801514,12168,21770,272,348919,530022,-181103,259324,440427
2021-09-03,826127,12477,24613,309,359224,542982,-183758,270668,454426
2021-09-04,841831,12825,15704,348,359043,546490,-187447,282516,469963
2021-09-05,863499,13107,21668,282,366501,558665,-192164,291727,483891
2021-09-06,884091,13419,20592,312,369489,569215,-199726,301457,501183
2021-09-07,907527,13736,23436,317,371847,582081,-210234,311710,521944
2021-09-08,928445,14161,20918,425,373755,588637,-214882,325647,540529
2021-09-09,948928,14507,20483,346,375623,596251,-220628,338170,558798
2021-09-10,970900,14783,21972,276,380706,605196,-224490,350921,575411
2021-09-11,990585,15057,19685,274,382562,612066,-229504,363462,592966
2021-09-12,1010429,15319,19844,262,382466,620532,-238066,374578,612644
2021-09-13,1028861,15701,18432,382,374246,627382,-253136,385778,638914
2021-09-14,1046198,15978,17337,277,370372,631759,-261387,398461,659848
2021-09-15,1063659,16229,17461,251,367895,634780,-266885,412650,679535
2021-09-16,1080963,16468,17304,239,364099,640944,-276845,423551,700396
2021-09-17,1099965,16680,19002,212,359668,649820,-290152,433465,723617
2021-09-18,1115429,16900,15464,220,354327,650161,-295834,448368,744202
2021-09-19,1131992,17133,16563,233,352015,657354,-305339,457505,762844
2021-09-20,1146310,17348,14318,215,344581,664636,-320055,464326,784381
2021-09-21,1165601,17588,19291,240,339234,672670,-333436,475343,808779
2021-09-22,1184619,17824,19018,236,342552,679533,-336981,487262,824243
2021-09-23,1200249,18060,15630,236,336514,688701,-352187,493488,845675
2021-09-24,1214328,18263,14079,203,330034,690206,-360172,505859,866031
2021-09-25,1230335,18443,16007,180,322628,695443,-372815,516449,889264
2021-09-26,1246846,18627,16511,184,318217,700293,-382076,527926,910002
2021-09-27,1262288,18801,15442,174,313186,705033,-391847,538454,930301
2021-09-28,1275491,18979,13203,178,304413,696571,-392158,559941,952099
2021-09-29,1289934,19141,14443,162,299187,687284,-388097,583509,971606
2021-09-30,1303032,19344,13098,203,292400,674857,-382457,608831,991288
2021-10-01,1314507,19480,11475,136,285510,658946,-373436,636081,1009517
2021-10-02,1323567,19644,9060,164,277205,638985,-361780,664938,1026718
2021-10-03,1332439,19758,8872,114,268666,618884,-350218,693797,1044015
2021-10-04,1341321,19888,8882,130,260228,599953,-339725,721480,1061205
2021-10-05,1348521,20022,7200,134,248422,581446,-333024,747053,1080077
2021-10-06,1355721,20141,7200,119,240173,578494,-338321,757086,1095407
2021-10-07,1362573,20266,6852,125,230456,583819,-353363,758488,1111851
2021-10-08,1370465,20380,7892,114,224041,590603,-366562,759482,1126044
2021-10-09,1377913,20485,7448,105,212207,596627,-384420,760801,1145221
2021-10-10,1383733,20598,5820,113,199001,580936,-381935,782199,1164134
2021-10-11,1389703,20713,5970,115,189339,584242,-394903,784748,1179651
2021-10-12,1394564,20806,4861,93,180143,587663,-407520,786095,1193615
2021-10-13,1400273,20912,5709,106,169832,592075,-422243,787286,1209529
2021-10-14,1407126,20993,6853,81,160199,598128,-437929,788005,1225934
2021-10-15,1413387,21086,6261,93,151006,603378,-452372,788923,1241295
2021-10-16,1418697,21174,5310,88,143118,607019,-463901,790504,1254405
2021-10-17,1423961,21237,5264,63,133964,610880,-476916,791844,1268760
2021-10-18,1429183,21312,5222,75,126076,614891,-488815,792980,1281795
2021-10-19,1434183,21387,5000,75,119601,617950,-498349,794846,1293195
2021-10-20,1440194,21459,6011,72,116555,622152,-505597,796583,1302180
2021-10-21,1446190,21530,5996,71,113680,626536,-512856,798124,1310980
2021-10-22,1452764,21586,6574,56,111387,627852,-516465,803326,1319791
2021-10-23,1458326,21663,5562,77,109728,631999,-522271,804664,1326935
2021-10-24,1465001,21716,6675,53,109227,637307,-528080,805978,1334058
2021-10-25,1471000,21781,5999,65,108362,641918,-533556,807301,1340857
2021-10-26,1476926,21845,5926,64,106397,644791,-538394,810290,1348684
2021-10-27,1484202,21899,7276,54,106235,649989,-543754,812314,1356068
2021-10-28,1492269,21953,8067,54,108482,656353,-547871,813963,1361834
2021-10-29,1500352,22009,8083,56,110593,662211,-551618,816132,1367750
2021-10-30,1508983,22073,8631,64,114355,668574,-554219,818336,1372555
2021-10-31,1518088,22126,9105,53,117762,675628,-557866,820334,1378200
2021-11-01,1527323,22174,9235,48,120149,683084,-562935,822065,1385000
2021-11-02,1536618,22248,9295,74,123157,689564,-566407,824806,1391213
2021-11-03,1548338,22326,11720,78,129563,692337,-562774,833675,1396449
2021-11-04,1559193,22385,10855,59,135173,701402,-566229,835406,1401635
2021-11-05,1571567,22455,12374,70,142314,711765,-569451,837347,1406798
2021-11-06,1583921,22513,12354,58,149680,722307,-572627,839101,1411728
2021-11-07,1596537,22574,12616,61,156282,733561,-577279,840402,1417681
2021-11-08,1609710,22641,13173,67,163453,745594,-582141,841475,1423616
2021-11-09,1623124,22729,13414,88,170272,757595,-587323,842800,1430123
2021-11-10,1636208,22808,13084,79,177803,769346,-591543,844054,1435597
2021-11-11,1649670,22892,13462,84,184585,780830,-596245,845948,1442193
2021-11-12,1664482,22973,14812,81,193401,785298,-591897,856211,1448108
2021-11-13,1678450,23061,13968,88,201436,797335,-595899,858054,1453953
2021-11-14,1691933,23125,13483,64,207667,805497,-597830,863311,1461141
2021-11-15,1706147,23226,14214,101,213777,818405,-604628,864516,1469144
2021-11-16,1723070,23313,16923,87,222631,828760,-606129,870997,1477126
2021-11-17,1739314,23380,16244,67,230264,841064,-610800,874870,1485670
2021-11-18,1756174,23519,16860,139,237947,851062,-613115,881593,1494708
2021-11-19,1772049,23621,15875,102,244624,864864,-620240,883564,1503804
2021-11-20,1787765,23728,15716,107,251040,863700,-612660,900337,1512997
2021-11-21,1804080,23804,16315,76,255666,874776,-619110,905500,1524610
2021-11-22,1821113,23994,17033,190,261730,886843,-625113,910276,1535389
2021-11-23,1839029,24161,17916,167,267295,903558,-636263,911310,1547573
2021-11-24,1858028,24286,18999,125,273982,896481,-622499,937261,1559760
2021-11-25,1878055,24450,20027,164,281354,910717,-629363,942888,1572251
2021-11-26,1899149,24587,21094,137,289302,919306,-630004,955256,1585260
2021-11-27,1924994,24735,25845,148,301722,943335,-641613,956924,1598537
2021-11-28,1945812,24925,20818,190,309414,962251,-652837,958636,1611473
2021-11-29,1967966,25098,22154,173,318123,968144,-650021,974724,1624745
2021-11-30,1990442,25295,22476,197,325763,975799,-650036,989348,1639384
2021-12-01,2013784,25491,23342,196,335138,996241,-661103,992052,1653155
2021-12-02,2035819,25701,22035,210,343676,1004808,-661132,1005310,1666442
2021-12-03,2057794,25901,21975,200,351447,1025434,-673987,1006459,1680446
2021-12-04,2080305,26104,22511,203,357032,1046635,-689603,1007566,1697169
2021-12-05,2103316,26303,23011,199,363803,1067736,-703933,1009277,1713210
2021-12-06,2126772,26526,23456,223,370375,1089839,-719464,1010407,1729871
2021-12-07,2149023,26743,22251,217,376757,1110624,-733867,1011656,1745523
2021-12-08,2172488,26973,23465,230,384493,1109122,-724629,1036393,1761022
2021-12-09,2197101,27230,24613,257,392764,1118892,-726128,1050979,1777107
2021-12-10,2220957,27446,23856,216,399628,1141170,-741542,1052341,1793883
2021-12-11,2246907,27655,25950,209,407669,1165827,-758158,1053425,1811583
2021-12-12,2270440,27883,23533,228,412184,1187837,-775653,1054720,1830373
2021-12-13,2295159,28126,24719,243,416861,1211121,-794260,1055912,1850172
2021-12-14,2319630,28379,24471,253,420228,1230815,-810587,1060436,1871023
2021-12-15,2344590,28663,24960,284,419312,1252499,-833187,1063428,1896615
2021-12-16,2368825,28904,24235,241,422772,1275460,-852688,1064461,1917149
2021-12-17,2393009,29151,24184,247,424796,1268340,-843544,1095518,1939062
2021-12-18,2418237,29400,25228,249,427546,1291674,-864128,1097163,1961291
2021-12-19,2443811,29615,25574,215,429812,1306234,-876422,1107962,1984384
2021-12-20,2467589,29840,23778,225,431545,1327850,-896305,1109899,2006204
2021-12-21,2493502,30091,25913,251,435457,1303321,-867864,1160090,2027954
2021-12-22,2519781,30301,26279,210,439266,1315996,-876730,1173484,2050214
2021-12-23,2545775,30582,25994,281,442178,1330765,-888587,1184428,2073015
2021-12-24,2571419,30817,25644,235,444412,1325341,-880929,1215261,2096190
2021-12-25,2596154,31058,24735,241,446890,1335412,-888522,1229684,2118206
2021-12-26,2620309,31265,24155,207,447614,1340804,-893190,1248240,2141430
2021-12-27,2643918,31469,23609,204,446613,1352835,-906222,1259614,2165836
2021-12-28,2666839,31683,22921,214,445668,1370874,-925206,1264282,2189488
2021-12-29,2688884,31928,22045,245,441732,1354414,-912682,1302542,2215224
2021-12-30,2720415,32168,31531,240,449735,1351603,-901868,1336644,2238512
2021-12-31,2746628,32394,26213,226,451243,1358948,-907705,1355286,2262991
2022-01-01,2770171,32610,23543,216,450325,1362284,-911959,1375277,2287236
2022-01-02,2797070,32831,26899,221,452259,1357541,-905282,1406698,2311980
2022-01-03,2822364,33021,25294,190,453349,1341183,-887834,1448160,2335994
2022-01-04,2845858,33245,23494,224,452625,1331225,-878600,1481388,2359988
2022-01-05,2872764,33474,26906,229,454298,1318239,-863941,1521051,2384992
2022-01-06,2898673,33644,25909,170,454692,1298608,-843916,1566421,2410337
2022-01-07,2924278,33877,25605,233,456456,1292346,-835890,1598055,2433945
2022-01-08,2950317,34117,26039,240,456575,1292154,-835579,1624046,2459625
2022-01-09,2975038,34319,24721,202,455055,1287462,-832407,1653257,2485664
2022-01-10,2998256,34531,23218,212,452269,1203621,-751352,1760104,2511456
2022-01-11,3023382,34787,25126,256,451707,1204624,-752917,1783971,2536888
2022-01-12,3048506,34964,25124,177,452175,1173631,-721456,1839911,2561367
2022-01-13,3074547,35170,26041,206,454032,1156434,-702402,1882943,2585345
2022-01-14,3099519,35341,24972,171,455430,1159944,-704514,1904234,2608748
2022-01-15,3125017,35480,25498,139,458039,1116558,-658519,1972979,2631498
2022-01-16,3149435,35609,24418,129,460422,1114520,-654098,1999306,2653404
2022-01-17,3174869,35788,25434,179,454275,1102602,-648327,2036479,2684806
2022-01-18,3201016,35972,26147,184,454204,1102872,-648668,2062172,2710840
2022-01-19,3225799,36114,24783,142,455486,1077478,-621992,2112207,2734199
2022-01-20,3251756,36266,25957,152,454534,1080546,-626012,2134944,2760956
2022-01-21,3276501,36443,24745,177,453960,1085857,-631897,2154201,2786098
2022-01-22,3300891,36596,24390,153,454880,1089581,-634701,2174714,2809415
2022-01-23,3324150,36719,23259,123,451263,1091559,-640296,2195872,2836168
2022-01-24,3346453,36884,22303,165,447615,1060365,-612750,2249204,2861954
2022-01-25,3370903,37010,24450,126,446499,1004799,-558300,2329094,2887394
2022-01-26,3395680,37165,24777,155,445208,991880,-546672,2366635,2913307
2022-01-27,3420098,37291,24418,126,444934,978169,-533235,2404638,2937873
2022-01-28,3443279,37432,23181,141,444882,979575,-534693,2426272,2960965
2022-01-29,3466803,37547,23524,115,443306,973630,-530324,2455626,2985950
2022-01-30,3487918,37668,21115,121,439291,922605,-483314,2527645,3010959
2022-01-31,3507460,37777,19542,109,432804,920202,-487398,2549481,3036879
2022-02-01,3524454,37872,16994,95,424840,880492,-455652,2606090,3061742
2022-02-02,3537933,37968,13479,96,412820,870079,-457259,2629886,3087145
2022-02-03,3551192,38063,13259,95,401662,841148,-439486,2671981,3111467
2022-02-04,3569072,38147,17880,84,394119,833434,-439315,2697491,3136806
2022-02-05,3587833,38261,18761,114,386703,831623,-444920,2717949,3162869
2022-02-06,3609587,38324,21754,63,383725,829510,-445785,2741753,3187538
2022-02-07,3635510,38424,25923,100,383654,828666,-445012,2768420,3213432
2022-02-08,3669290,38521,33780,97,392692,840950,-448258,2789819,3238077
2022-02-09,3706221,38614,36931,93,405237,790961,-385724,2876646,3262370
2022-02-10,3746358,38688,40137,74,422134,804030,-381896,2903640,3285536
2022-02-11,3787197,38784,40839,96,440648,821696,-381048,2926717,3307765
2022-02-12,3829302,38862,42105,78,458321,840451,-382130,2949989,3332119
2022-02-13,3869974,38946,40672,84,474210,856222,-382012,2974806,3356818
2022-02-14,3915320,39037,45346,91,495131,878282,-383151,2998001,3381152
2022-02-15,3964375,39122,49055,85,521011,900924,-379913,3024329,3404242
2022-02-16,4017935,39188,53560,66,551066,930534,-379468,3048213,3427681
2022-02-17,4073747,39278,55812,90,585739,963444,-377705,3071025,3448730
2022-02-18,4139175,39358,65428,80,631635,1005575,-373940,3094242,3468182
2022-02-19,4203587,39423,64412,65,679068,1046080,-367012,3118084,3485096
2022-02-20,4276012,39501,72425,78,738001,1088011,-350010,3148500,3498510
2022-02-21,4348360,39605,72348,104,797064,1130018,-332954,3178737,3511691
2022-02-22,4434102,39682,85742,77,864953,1188269,-323316,3206151,3529467
2022-02-23,4525611,39773,91509,91,937687,1247044,-309357,3238794,3548151
2022-02-24,4630895,39884,105284,111,1021197,1316153,-294956,3274858,3569814
2022-02-25,4750893,39962,119998,78,1115305,1403236,-287931,3307695,3595626
2022-02-26,4868860,40050,117967,88,1199482,1483686,-284204,3345124,3629328
2022-02-27,4999850,40144,130990,94,1293535,1561714,-268179,3397992,3666171
2022-02-28,5140785,40252,140935,108,1394319,1658500,-264181,3442033,3706214
2022-03-01,5287598,40338,146813,86,1500315,1747293,-246978,3499967,3746945
2022-03-02,5449668,40452,162070,114,1620252,1855345,-235093,3553871,3788964
2022-03-03,5621554,40547,171886,95,1751485,1976394,-224909,3604613,3829522
2022-03-04,5801056,40644,179502,97,1885639,2099886,-214247,3660526,3874773
2022-03-05,5987558,40726,186502,82,2023101,2242738,-219637,3704094,3923731
2022-03-06,6185845,40813,198287,87,2167823,2358491,-190668,3786541,3977209
2022-03-07,6391416,40891,205571,78,2317591,2509989,-192398,3840536,4032934
2022-03-08,6616431,40977,225015,86,2477170,2647014,-169844,3928440,4098284
2022-03-09,6839735,41086,223304,109,2636039,2787335,-151296,4011314,4162610
2022-03-10,7055246,41157,215511,71,2779163,2932622,-153459,4081467,4234926
2022-03-11,7281248,41228,226002,71,2932817,3066694,-133877,4173326,4307203
2022-03-12,7495491,41290,214243,62,3061327,3179062,-117735,4275139,4392874
2022-03-13,7705995,41385,210504,95,3180289,3276931,-96642,4387679,4484321
2022-03-14,7905918,41477,199923,92,3274931,3351353,-76422,4513088,4589510
2022-03-15,8123469,41545,217551,68,3372508,3440670,-68162,4641254,4709416
2022-03-16,8344381,41607,220912,62,3475459,3480172,-4713,4822602,4827315
2022-03-17,8556822,41683,212441,76,3556896,3537035,19861,4978104,4958243
2022-03-18,8750649,41740,193827,57,3609807,3537832,71975,5171077,5099102
2022-03-19,8951837,41817,201188,77,3664162,3592507,71655,5317513,5245858
2022-03-20,9113490,41880,161653,63,3663759,3625460,38299,5446150,5407851
2022-03-21,9264336,41949,150846,69,3642713,3579595,63118,5642792,5579674
2022-03-22,9411898,42014,147562,65,3610777,3523953,86824,5845931,5759107
2022-03-23,9556016,42075,144118,61,3568397,3458543,109854,6055398,5945544
2022-03-24,9691254,42145,135238,70,3505339,3411955,93384,6237154,6143770
2022-03-25,9813323,42196,122069,51,3421856,3341431,80425,6429696,6349271
2022-03-26,9928113,42258,114790,62,3311620,3274604,37016,6611251,6574235
2022-03-27,10030423,42306,102310,48,3190640,3174003,16637,6814114,6797477
2022-03-28,10121413,42358,90990,52,3066115,3125209,-59094,6953846,7012940
2022-03-29,10217618,42413,96205,55,2936315,3021359,-85044,7153846,7238890
2022-03-30,10310977,42454,93359,41,2815445,2999992,-184547,7268531,7453078
2022-03-31,10398869,42493,87892,39,2692835,2837363,-144528,7519013,7663541
2022-04-01,10477642,42526,78773,33,2571691,2828640,-256949,7606476,7863425
2022-04-02,10548886,42563,71244,37,2425380,2792969,-367589,7713354,8080943
2022-04-03,10603674,42600,54788,37,2259256,2773112,-513856,7787962,8301818
2022-04-04,10656288,42642,52614,42,2099424,2769811,-670387,7843835,8514222
2022-04-05,10715681,42681,59393,39,1964993,2525710,-560717,8147290,8708007
2022-04-06,10768684,42712,53003,31,1816816,2448409,-631593,8277563,8909156
2022-04-07,10817975,42733,49291,21,1704464,2380176,-675712,8395066,9070778
2022-04-08,10860120,42768,42145,35,1595749,2361677,-765928,8455675,9221603
2022-04-09,10896698,42794,36578,26,1484774,2356372,-871598,8497532,9369130
2022-04-10,10927030,42813,30332,19,1370995,2351694,-980699,8532523,9513222
2022-04-11,10951802,42830,24772,17,1260531,2354049,-1093518,8554923,9648441
2022-04-12,10976168,42858,24366,28,1162817,2176203,-1013386,8757107,9770493
2022-04-13,11002478,42878,26310,20,1074345,2188606,-1114261,8770994,9885255
2022-04-14,11027065,42901,24587,23,996619,2127537,-1130918,8856627,9987545
2022-04-15,11048405,42924,21340,23,926969,2142437,-1215468,8863044,10078512
2022-04-16,11068032,42934,19627,10,850404,2093724,-1243320,8931374,10174694
2022-04-17,11083608,42944,15576,10,772621,2103818,-1331197,8936846,10268043
2022-04-18,11096333,42957,12725,13,697451,2112312,-1414861,8941064,10355925
2022-04-19,11110632,42975,14299,18,632972,2001963,-1368991,9065694,10434685
2022-04-20,11124688,42982,14056,7,575795,2013472,-1437677,9068234,10505911
2022-04-21,11137409,42991,12721,9,533726,2017491,-1483765,9076927,10560692
2022-04-22,11149209,42998,11800,7,492914,2026946,-1534032,9079265,10613297
2022-04-23,11160168,43004,10959,6,444481,2035670,-1591189,9081494,10672683
2022-04-24,11169488,43013,9320,9,400795,2040400,-1639605,9086075,10725680
2022-04-25,11177332,43021,7844,8,359349,2041551,-1682202,9092760,10774962
2022-04-26,11186214,43029,8882,8,326086,2026960,-1700874,9116225,10817099
2022-04-27,11194643,43034,8429,5,297940,1988477,-1690537,9163132,10853669
2022-04-28,11202139,43037,7496,3,275106,1916799,-1641693,9242303,10883996
2022-04-29,11208531,43038,6392,1,256728,1919965,-1663237,9245528,10908765
2022-04-30,11213909,43041,5378,3,237738,1908613,-1670875,9262255,10933130
2022-05-01,11217822,43042,3913,1,215343,1910414,-1695071,9264366,10959437
2022-05-02,11221109,43044,3287,2,194042,1912609,-1718567,9265456,10984023
2022-05-03,11223959,43044,2850,0,175554,1913634,-1738080,9267281,11005361
2022-05-04,11227209,43047,3250,3,159174,1874826,-1715652,9309336,11024988
2022-05-05,11231740,43049,4531,2,148130,1874271,-1726141,9314420,11040561
2022-05-06,11235759,43055,4019,6,139420,1876467,-1737047,9316237,11053284
2022-05-07,11239279,43055,3520,0,128647,1877699,-1749052,9318525,11067577
2022-05-08,11241667,43056,2388,1,116978,1878020,-1761042,9320591,11081633
2022-05-09,11243956,43057,2289,1,106546,1878734,-1772188,9322165,11094353
2022-05-10,11246961,43058,3005,1,97751,1878969,-1781218,9324934,11106152
2022-05-11,11249862,43060,2901,2,89692,1879279,-1789587,9327523,11117110
2022-05-12,11254018,43063,4156,3,84527,1875991,-1791464,9334964,11126428
2022-05-13,11256360,43063,2342,0,79028,1869268,-1790240,9344029,11134269
2022-05-14,11258354,43065,1994,2,72138,1865697,-1793559,9349592,11143151
2022-05-15,11260032,43065,1678,0,65389,1861927,-1796538,9355040,11151578
2022-05-16,11261663,43067,1631,2,59522,1858833,-1799311,9359763,11159074
2022-05-17,11263541,43071,1878,4,55006,1855613,-1800607,9364857,11165464
2022-05-18,11265467,43072,1926,1,51557,1849101,-1797544,9373294,11170838
2022-05-19,11267272,43073,1805,1,49449,1841318,-1791869,9382881,11174750
2022-05-20,11268941,43075,1669,2,47830,1835834,-1788004,9390032,11178036
2022-05-21,11270474,43075,1533,0,46515,1834298,-1787783,9393101,11180884
2022-05-22,11271862,43075,1388,0,44653,1826741,-1782088,9402046,11184134
2022-05-23,11273102,43076,1240,1,41361,1824118,-1782757,9405908,11188665
2022-05-24,11274494,43076,1392,0,38735,1819015,-1780280,9412403,11192683
2022-05-25,11275908,43078,1414,2,36627,1817968,-1781341,9414862,11196203
2022-05-26,11277249,43078,1341,0,35582,1812086,-1776504,9422085,11198589
2022-05-27,11278552,43078,1303,0,34596,1804024,-1769428,9431450,11200878
2022-05-28,11279724,43078,1172,0,32763,1796733,-1763970,9439913,11203883
2022-05-29,11280660,43078,936,0,30798,1789230,-1758432,9448352,11206784
2022-05-30,11281836,43078,1176,0,27818,1782217,-1754399,9456541,11210940
2022-05-31,11282898,43079,1062,1,26537,1777521,-1750984,9462298,11213282
2022-06-01,11283999,43079,1101,0,25645,1769080,-1743435,9471840,11215275
2022-06-02,11285143,43080,1144,1,25110,1764403,-1739293,9477660,11216953
2022-06-03,11286236,43080,1093,0,24573,1756350,-1731777,9486806,11218583
2022-06-04,11287162,43080,926,0,23621,1747675,-1724054,9496407,11220461
2022-06-05,11287883,43080,721,0,22416,1739848,-1717432,9504955,11222387
2022-06-06,11288730,43081,847,1,21457,1731668,-1710211,9513981,11224192
2022-06-07,11289740,43081,1010,0,20799,1723369,-1702570,9523290,11225860
2022-06-08,11290700,43081,960,0,20226,1715966,-1695740,9531653,11227393
2022-06-09,11291543,43081,843,0,19681,1712464,-1692783,9535998,11228781
2022-06-10,11292554,43082,1011,1,19451,1708874,-1689423,9540598,11230021
2022-06-11,11293301,43083,747,1,18806,1702299,-1683493,9547919,11231412
2022-06-12,11293898,43083,597,0,17990,1697622,-1679632,9553193,11232825
2022-06-13,11294547,43083,649,0,17298,1688941,-1671643,9562523,11234166
2022-06-14,11295447,43083,900,0,16895,1683476,-1666581,9568888,11235469
2022-06-15,11296357,43083,910,0,16633,1679004,-1662371,9574270,11236641
2022-06-16,11297171,43083,814,0,16511,1670983,-1654472,9583105,11237577
2022-06-17,11297931,43083,760,0,16095,1663362,-1647267,9591486,11238753
2022-06-18,11298666,43083,735,0,15768,1658208,-1642440,9597375,11239815
2022-06-19,11299227,43083,561,0,15228,1654514,-1639286,9601630,11240916
2022-06-20,11299774,43083,547,0,14631,1645291,-1630660,9611400,11242060
2022-06-21,11300561,43084,787,1,14324,1640297,-1625973,9617180,11243153
2022-06-22,11301555,43084,994,0,14393,1635634,-1621241,9622837,11244078
2022-06-23,11302333,43084,778,0,14450,1631325,-1616875,9627924,11244799
2022-06-24,11303019,43084,686,0,14289,1622660,-1608371,9637275,11245646
2022-06-25,11303710,43084,691,0,13970,1618112,-1604142,9642514,11246656
2022-06-26,11304296,43084,586,0,13596,1611398,-1597802,9649814,11247616
2022-06-27,11304966,43084,670,0,13423,1605415,-1591992,9656467,11248459
2022-06-28,11305775,43087,809,3,13218,1596716,-1583498,9665972,11249470
2022-06-29,11306592,43087,817,0,13291,1588146,-1574855,9675359,11250214
2022-06-30,11307474,43087,882,0,13576,1583069,-1569493,9681318,11250811
2022-07-01,11308449,43087,975,0,13902,1575699,-1561797,9689663,11251460
2022-07-02,11309217,43087,768,0,13770,1566773,-1553003,9699357,11252360
2022-07-03,11309754,43087,537,0,13397,1557683,-1544286,9708984,11253270
2022-07-04,11310475,43088,721,1,13303,1552224,-1538921,9715163,11254084
2022-07-05,11311516,43089,1041,1,13584,1543505,-1529921,9724922,11254843
2022-07-06,11312476,43089,960,0,13810,1536839,-1523029,9732548,11255577
2022-07-07,11313438,43089,962,0,14211,1529239,-1515028,9741110,11256138
2022-07-08,11314279,43089,841,0,14505,1521325,-1506820,9749865,11256685
2022-07-09,11314999,43089,720,0,14438,1515523,-1501085,9756387,11257472
2022-07-10,11315488,43089,489,0,13933,1507535,-1493602,9764864,11258466
2022-07-11,11316085,43089,597,0,13752,1501975,-1488223,9771021,11259244
2022-07-12,11317005,43090,920,1,13985,1493743,-1479758,9780172,11259930
2022-07-13,11318057,43090,1052,0,14347,1489712,-1475365,9785255,11260620
2022-07-14,11319037,43090,980,0,14741,1482147,-1467406,9793800,11261206
2022-07-15,11320043,43090,1006,0,15077,1477984,-1462907,9798969,11261876
2022-07-16,11320784,43091,741,1,15008,1471365,-1456357,9806328,11262685
2022-07-17,11321568,43091,784,0,14976,1464201,-1449225,9814276,11263501
2022-07-18,11322464,43091,896,0,14990,1461016,-1446026,9818357,11264383
2022-07-19,11323606,43091,1142,0,15157,1456941,-1441784,9823574,11265358
2022-07-20,11324826,43091,1220,0,15609,1449089,-1433480,9832646,11266126
2022-07-21,11326184,43091,1358,0,16430,1445448,-1429018,9837645,11266663
2022-07-22,11327386,43092,1202,1,16910,1442118,-1425208,9842176,11267384
2022-07-23,11328512,43092,1126,0,16996,1433916,-1416920,9851504,11268424
2022-07-24,11329299,43092,787,0,16823,1424931,-1408108,9861276,11269384
2022-07-25,11330241,43092,942,0,16803,1420181,-1403378,9866968,11270346
2022-07-26,11331778,43092,1537,0,17499,1414611,-1397112,9874075,11271187
2022-07-27,11333633,43092,1855,0,18634,1408950,-1390316,9881591,11271907
2022-07-28,11335420,43092,1787,0,19932,1403860,-1383928,9888468,11272396
2022-07-29,11337319,43093,1899,1,21233,1396681,-1375448,9897545,11272993
2022-07-30,11339075,43093,1756,0,22070,1390463,-1368393,9905519,11273912
2022-07-31,11340629,43093,1554,0,22572,1384140,-1361568,9913396,11274964
2022-08-01,11342096,43093,1467,0,23059,1375959,-1352900,9923044,11275944
2022-08-02,11344200,43094,2104,1,24156,1368394,-1344238,9932712,11276950
2022-08-03,11346405,43094,2205,0,25621,1362849,-1337228,9940462,11277690
2022-08-04,11348447,43094,2042,0,26879,1357179,-1330300,9948174,11278474
2022-08-05,11350551,43094,2104,0,28087,1349802,-1321715,9957655,11279370
2022-08-06,11352161,43094,1610,0,28555,1344534,-1315979,9964533,11280512
2022-08-07,11353543,43094,1382,0,28717,1337327,-1308610,9973122,11281732
2022-08-08,11355249,43094,1706,0,29065,1329810,-1300745,9982345,11283090
2022-08-09,11357590,43094,2341,0,30204,1322631,-1292427,9991865,11284292
2022-08-10,11359601,43095,2011,1,31088,1319370,-1288282,9997136,11285418
2022-08-11,11362238,43095,2637,0,32939,1315589,-1282650,10003554,11286204
2022-08-12,11364430,43096,2192,1,34188,1311883,-1277695,10009451,11287146
2022-08-13,11366246,43097,1816,1,34467,1308512,-1274045,10014637,11288682
2022-08-14,11367674,43098,1428,1,34040,1304007,-1269967,10020569,11290536
2022-08-15,11369369,43098,1695,0,33949,1296445,-1262496,10029826,11292322
2022-08-16,11372353,43100,2984,2,35032,1294213,-1259181,10035040,11294221
2022-08-17,11375167,43103,2814,3,36089,1291726,-1255637,10040338,11295975
2022-08-18,11378463,43103,3296,0,37834,1286145,-1248311,10049215,11297526
2022-08-19,11381447,43103,2984,0,39351,1282154,-1242803,10056190,11298993
2022-08-20,11384151,43104,2704,1,39950,1278462,-1238512,10062585,11301097
2022-08-21,11385712,43105,1561,1,39306,1270150,-1230844,10072457,11303301
2022-08-22,11387966,43106,2254,1,39518,1264179,-1224661,10080681,11305342
2022-08-23,11391162,43106,3196,0,40611,1258008,-1217397,10090048,11307445
2022-08-24,11394758,43108,3596,2,42595,1247470,-1204875,10104180,11309055
2022-08-25,11398101,43110,3343,2,44556,1238064,-1193508,10116927,11310435
2022-08-26,11401297,43110,3196,0,46048,1231922,-1185874,10126265,11312139
2022-08-27,11403494,43111,2197,1,45903,1220179,-1174276,10140204,11314480
2022-08-28,11405199,43112,1705,1,45597,1211965,-1166368,10150122,11316490
2022-08-29,11407608,43113,2409,1,45369,1207366,-1161997,10157129,11319126
2022-08-30,11410850,43117,3242,4,46416,1197462,-1151046,10170271,11321317
2022-08-31,11413577,43117,2727,0,47331,1191700,-1144369,10178760,11323129
2022-09-01,11416257,43117,2680,0,48583,1185353,-1136770,10187787,11324557
2022-09-02,11417806,43118,1549,1,48436,1178814,-1130378,10195874,11326252
2022-09-03,11419402,43119,1596,1,47048,1171110,-1124062,10205173,11329235
2022-09-04,11420792,43120,1390,1,45624,1166109,-1120485,10211563,11332048
2022-09-05,11422958,43122,2166,2,44493,1147555,-1103062,10232281,11335343
2022-09-06,11426654,43123,3696,1,45206,1145560,-1100354,10237971,11338325
2022-09-07,11430532,43125,3878,2,46379,1134509,-1088130,10252898,11341028
2022-09-08,11433729,43126,3197,1,48016,1129202,-1081186,10261401,11342587
2022-09-09,11437374,43126,3645,0,49408,1115271,-1065863,10278977,11344840
2022-09-10,11439872,43126,2498,0,48710,1109603,-1060893,10287143,11348036
2022-09-11,11441515,43129,1643,3,46754,1076383,-1029629,10322003,11351632
2022-09-12,11443528,43130,2013,1,45426,1063261,-1017835,10337137,11354972
2022-09-13,11446830,43132,3302,2,45531,1055394,-1009863,10348304,11358167
2022-09-14,11449940,43132,3110,0,46446,1013176,-966730,10393632,11360362
2022-09-15,11452904,43137,2964,5,47700,960954,-913254,10448813,11362067
2022-09-16,11455985,43137,3081,0,48377,904112,-855735,10508736,11364471
2022-09-17,11458464,43138,2479,1,47613,836936,-789323,10578390,11367713
2022-09-18,11460355,43139,1891,1,46777,838187,-791410,10579029,11370439
2022-09-19,11462133,43141,1778,2,45874,839404,-793530,10579588,11373118
2022-09-20,11465311,43142,3178,1,47504,841147,-793643,10581022,11374665
2022-09-21,11467599,43146,2288,4,48193,841765,-793572,10582688,11376260
2022-09-22,11469527,43146,1928,0,48735,842434,-793699,10583947,11377646
2022-09-23,11472072,43146,2545,0,49114,843660,-794546,10585266,11379812
2022-09-24,11473248,43146,1176,0,46594,843906,-797312,10586196,11383508
2022-09-25,11474209,43146,961,0,43677,844202,-800525,10586861,11387386
2022-09-26,11475644,43146,1435,0,41915,844937,-803022,10587561,11390583
2022-09-27,11477229,43147,1585,1,39854,845294,-805440,10588788,11394228
2022-09-28,11478816,43147,1587,0,38944,845852,-806908,10589817,11396725
2022-09-29,11479794,43148,978,1,38278,845729,-807451,10590917,11398368
2022-09-30,11481265,43148,1471,0,37737,846252,-808515,10591865,11400380
2022-10-01,11481936,43149,671,1,35105,846195,-811090,10592592,11403682
2022-10-02,11482426,43149,490,0,32486,846366,-813880,10592911,11406791
2022-10-03,11483222,43149,796,0,30318,846892,-816574,10593181,11409755
2022-10-04,11484243,43151,1021,2,28256,847106,-818850,10593986,11412836
2022-10-05,11485437,43151,1194,0,26973,847442,-820469,10594844,11415313
2022-10-06,11486567,43151,1130,0,26212,848057,-821845,10595359,11417204
2022-10-07,11487269,43152,702,1,25135,848321,-823186,10595796,11418982
2022-10-08,11487951,43153,682,1,22639,848611,-825972,10596187,11422159
2022-10-09,11488322,43153,371,0,20723,848833,-828110,10596336,11424446
2022-10-10,11489367,43153,1045,0,19840,849705,-829865,10596509,11426374
2022-10-11,11490595,43154,1228,1,18522,850305,-831783,10597136,11428919
2022-10-12,11491790,43155,1195,1,18541,851093,-832552,10597542,11430094
2022-10-13,11492860,43155,1070,0,18651,851752,-833101,10597953,11431054
2022-10-14,11493449,43155,589,0,17805,851850,-834045,10598444,11432489
2022-10-15,11494181,43155,732,0,16952,852293,-835341,10598733,11434074
2022-10-16,11494506,43155,325,0,15690,852377,-836687,10598974,11435661
2022-10-17,11495180,43157,674,2,15384,852822,-837438,10599201,11436639
2022-10-18,11495803,43158,623,1,14537,853085,-838548,10599560,11438108
2022-10-19,11497139,43159,1336,1,15202,854055,-838853,10599925,11438778
2022-10-20,11497680,43159,541,0,15254,854297,-839043,10600224,11439267
2022-10-21,11498262,43159,582,0,15040,854523,-839483,10600580,11440063
2022-10-22,11498737,43159,475,0,14494,854721,-840227,10600857,11441084
2022-10-23,11498895,43159,158,0,13458,854771,-841313,10600965,11442278
2022-10-24,11499441,43161,546,2,12872,855191,-842319,10601089,11443408
2022-10-25,11499955,43161,514,0,12686,855259,-842573,10601535,11444108
2022-10-26,11500781,43162,826,1,12829,855684,-842855,10601935,11444790
2022-10-27,11501265,43162,484,0,12943,855844,-842901,10602259,11445160
2022-10-28,11501906,43162,641,0,12539,856198,-843659,10602546,11446205
2022-10-29,11502170,43163,264,1,11574,856171,-844597,10602836,11447433
2022-10-30,11502475,43163,305,0,10685,856316,-845631,10602996,11448627
2022-10-31,11502885,43163,410,0,10025,856510,-846485,10603212,11449697
2022-11-01,11503335,43164,450,1,9885,856573,-846688,10603598,11450286
2022-11-02,11504091,43165,756,1,9909,856984,-847075,10603942,11451017
2022-11-03,11504910,43165,819,0,10404,857559,-847155,10604186,11451341
2022-11-04,11505249,43165,339,0,10069,857703,-847634,10604381,11452015
2022-11-05,11505608,43165,359,0,9805,857852,-848047,10604591,11452638
2022-11-06,11505849,43166,241,1,8709,858020,-849311,10604663,11453974
2022-11-07,11506214,43166,365,0,8534,858267,-849733,10604781,11454514
2022-11-08,11506656,43166,442,0,8394,858482,-850088,10605008,11455096
2022-11-09,11507124,43166,468,0,8387,858643,-850256,10605315,11455571
2022-11-10,11507540,43166,416,0,8645,858906,-850261,10605468,11455729
2022-11-11,11508170,43166,630,0,8729,859335,-850606,10605669,11456275
2022-11-12,11508447,43166,277,0,8492,859414,-850922,10605867,11456789
2022-11-13,11508689,43166,242,0,7908,859586,-851678,10605937,11457615
2022-11-14,11508893,43166,204,0,7628,859724,-852096,10606003,11458099
2022-11-15,11509473,43166,580,0,7567,860151,-852584,10606156,11458740
2022-11-16,11509975,43167,502,1,7804,860509,-852705,10606299,11459004
2022-11-17,11510484,43167,509,0,8009,860857,-852848,10606460,11459308
2022-11-18,11510919,43168,435,1,8033,861118,-853085,10606633,11459718
2022-11-19,11511178,43169,259,1,7842,861263,-853421,10606746,11460167
2022-11-20,11511452,43169,274,0,7361,861382,-854021,10606901,11460922
2022-11-21,11511822,43169,370,0,6912,861639,-854727,10607014,11461741
2022-11-22,11512138,43169,316,0,6889,861803,-854914,10607166,11462080
2022-11-23,11512684,43169,546,0,7076,862170,-855094,10607345,11462439
2022-11-24,11513173,43170,489,1,7323,862321,-854998,10607682,11462680
2022-11-25,11513747,43170,574,0,7533,862726,-855193,10607851,11463044
2022-11-26,11514174,43170,427,0,7518,862945,-855427,10608059,11463486
2022-11-27,11514532,43170,358,0,7408,863250,-855842,10608112,11463954
2022-11-28,11514865,43170,333,0,7325,863482,-856157,10608213,11464370
2022-11-29,11515423,43172,558,2,7251,863909,-856658,10608342,11465000
2022-11-30,11515908,43175,485,3,7458,864245,-856787,10608488,11465275
2022-12-01,11516489,43176,581,1,7799,864736,-856937,10608577,11465514
2022-12-02,11517124,43176,635,0,8231,865226,-856995,10608722,11465717
2022-12-03,11517518,43177,394,1,8044,865512,-857468,10608829,11466297
2022-12-04,11517722,43177,204,0,7747,865623,-857876,10608922,11466798
2022-12-05,11518149,43177,427,0,7665,865984,-858319,10608988,11467307
2022-12-06,11518511,43178,362,1,7591,866194,-858603,10609139,11467742
2022-12-07,11519011,43178,500,0,7833,866576,-858743,10609257,11468000
2022-12-08,11519541,43178,530,0,8089,866993,-858904,10609370,11468274
2022-12-09,11520037,43178,496,0,8215,867386,-859171,10609473,11468644
2022-12-10,11520445,43178,408,0,8307,867694,-859387,10609573,11468960
2022-12-11,11520639,43178,194,0,7955,867840,-859885,10609621,11469506
2022-12-12,11521022,43178,383,0,7849,868167,-860318,10609677,11469995
2022-12-13,11521388,43179,366,1,7640,868426,-860786,10609783,11470569
2022-12-14,11521708,43179,320,0,7534,868617,-861083,10609912,11470995
2022-12-15,11522098,43179,390,0,7566,868884,-861318,10610035,11471353
2022-12-16,11522431,43179,333,0,7566,869130,-861564,10610122,11471686
2022-12-17,11522750,43179,319,0,7327,869354,-862027,10610217,11472244
2022-12-18,11522927,43179,177,0,7019,869482,-862463,10610266,11472729
2022-12-19,11523163,43180,236,1,6673,869693,-863020,10610290,11473310
2022-12-20,11523367,43180,204,0,6243,869838,-863595,10610349,11473944
2022-12-21,11523567,43181,200,1,6048,869905,-863857,10610481,11474338
2022-12-22,11523781,43182,214,1,6058,870026,-863968,10610573,11474541
2022-12-23,11524095,43184,314,2,5944,870219,-864275,10610692,11474967
2022-12-24,11524202,43184,107,0,5691,870255,-864564,10610763,11475327
2022-12-25,11524273,43184,71,0,5262,870285,-865023,10610804,11475827
2022-12-26,11524436,43184,163,0,4895,870421,-865526,10610831,11476357
2022-12-27,11524647,43184,211,0,4610,870546,-865936,10610917,11476853
2022-12-28,11524779,43184,132,0,4334,870536,-866202,10611059,11477261
2022-12-29,11525013,43184,234,0,4374,870715,-866341,10611114,11477455
2022-12-30,11525145,43186,132,2,4121,870776,-866655,10611183,11477838
2022-12-31,11525231,43186,86,0,3843,870770,-866927,10611275,11478202
2023-01-01,11525284,43186,53,0,3576,870776,-867200,10611322,11478522
2023-01-02,11525337,43186,53,0,3239,870826,-867587,10611325,11478912
2023-01-03,11525408,43186,71,0,2977,870884,-867907,10611338,11479245
2023-01-04,11525491,43186,83,0,2741,870916,-868175,10611389,11479564
2023-01-05,11525571,43186,80,0,2644,870962,-868318,10611423,11479741
2023-01-06,11525647,43186,76,0,2484,871003,-868519,10611458,11479977
2023-01-07,11525711,43186,64,0,2344,871031,-868687,10611494,11480181
2023-01-08,11525763,43186,52,0,2196,871069,-868873,10611508,11480381
2023-01-09,11525834,43186,71,0,2053,871137,-869084,10611511,11480595
2023-01-10,11525911,43186,77,0,1816,871178,-869362,10611547,11480909
2023-01-11,11525946,43186,35,0,1744,871188,-869444,10611572,11481016
2023-01-12,11526034,43186,88,0,1761,871198,-869437,10611650,11481087
2023-01-13,11526089,43186,55,0,1653,870854,-869201,10612049,11481250
2023-01-14,11526118,43186,29,0,1471,870843,-869372,10612089,11481461
2023-01-15,11526140,43186,22,0,1361,870849,-869488,10612105,11481593
2023-01-16,11526167,43186,27,0,1154,870864,-869710,10612117,11481827
2023-01-17,11526213,43186,46,0,1068,870881,-869813,10612146,11481959
2023-01-18,11526254,43186,41,0,1023,870848,-869825,10612220,11482045
2023-01-19,11526284,43186,30,0,1000,870737,-869737,10612361,11482098
2023-01-20,11526301,43186,17,0,964,870723,-869759,10612392,11482151
2023-01-21,11526318,43186,17,0,910,870732,-869822,10612400,11482222
2023-01-22,11526329,43186,11,0,838,870734,-869896,10612409,11482305
2023-01-23,11526332,43186,3,0,761,870736,-869975,10612410,11482385
2023-01-24,11526339,43186,7,0,692,870740,-870048,10612413,11482461
2023-01-25,11526348,43186,9,0,637,870748,-870111,10612414,11482525
2023-01-26,11526365,43186,17,0,602,870753,-870151,10612426,11482577
2023-01-27,11526377,43186,12,0,543,870758,-870215,10612433,11482648
2023-01-28,11526395,43186,18,0,484,870771,-870287,10612438,11482725
2023-01-29,11526408,43186,13,0,462,870778,-870316,10612444,11482760
2023-01-30,11526461,43186,53,0,427,870828,-870401,10612447,11482848
2023-01-31,11526497,43186,36,0,408,870849,-870441,10612462,11482903
2023-02-01,11526508,43186,11,0,390,870843,-870453,10612479,11482932
2023-02-02,11526522,43186,14,0,382,870142,-869760,10613194,11482954
2023-02-03,11526543,43186,21,0,376,870158,-869782,10613199,11482981
2023-02-04,11526559,43186,16,0,346,868792,-868446,10614581,11483027
2023-02-05,11526566,43186,7,0,312,868794,-868482,10614586,11483068
2023-02-06,11526577,43186,11,0,293,868800,-868507,10614591,11483098
2023-02-07,11526591,43186,14,0,290,868812,-868522,10614593,11483115
2023-02-08,11526610,43186,19,0,292,868826,-868534,10614598,11483132
2023-02-09,11526627,43186,17,0,298,868797,-868499,10614644,11483143
2023-02-10,11526640,43186,13,0,308,868800,-868492,10614654,11483146
2023-02-11,11526651,43186,11,0,312,868805,-868493,10614660,11483153
2023-02-12,11526692,43186,41,0,344,868835,-868491,10614671,11483162
2023-02-13,11526704,43186,12,0,339,868839,-868500,10614679,11483179
2023-02-14,11526754,43186,50,0,377,868858,-868481,10614710,11483191
2023-02-15,11526773,43186,19,0,378,868875,-868497,10614712,11483209
2023-02-16,11526786,43186,13,0,378,868884,-868506,10614716,11483222
2023-02-17,11526799,43186,13,0,338,868897,-868559,10614716,11483275
2023-02-18,11526806,43186,7,0,309,868899,-868590,10614721,11483311
2023-02-19,11526810,43186,4,0,302,868902,-868600,10614722,11483322
2023-02-20,11526825,43186,15,0,303,868917,-868614,10614722,11483336
2023-02-21,11526834,43186,9,0,291,868920,-868629,10614728,11483357
2023-02-22,11526858,43186,24,0,299,868937,-868638,10614735,11483373
2023-02-23,11526870,43186,12,0,304,868944,-868640,10614740,11483380
2023-02-24,11526881,43186,11,0,304,868940,-868636,10614755,11483391
2023-02-25,11526891,43186,10,0,300,868946,-868646,10614759,11483405
2023-02-26,11526901,43186,10,0,291,868955,-868664,10614760,11483424
2023-02-27,11526905,43186,4,0,278,868956,-868678,10614763,11483441
2023-02-28,11526917,43186,12,0,277,868962,-868685,10614769,11483454
2023-03-01,11526926,43186,9,0,275,868963,-868688,10614777,11483465
2023-03-02,11526937,43186,11,0,245,868968,-868723,10614783,11483506
2023-03-03,11526950,43186,13,0,246,868976,-868730,10614788,11483518
2023-03-04,11526962,43186,12,0,208,868988,-868780,10614788,11483568
2023-03-05,11526966,43186,4,0,193,868990,-868797,10614790,11483587
2023-03-06,11526966,43186,0,0,180,868990,-868810,10614790,11483600
2023-03-07,11526986,43186,20,0,187,868998,-868811,10614802,11483613
2023-03-08,11526994,43186,8,0,188,869001,-868813,10614807,11483620
2023-03-09,11527012,43186,18,0,202,869017,-868815,10614809,11483624
2023-03-10,11527026,43186,14,0,201,869025,-868824,10614815,11483639
2023-03-11,11527033,43186,7,0,199,869030,-868831,10614817,11483648
2023-03-12,11527037,43186,4,0,179,869033,-868854,10614818,11483672
2023-03-13,11527046,43186,9,0,176,869041,-868865,10614819,11483684
2023-03-14,11527054,43186,8,0,173,869045,-868872,10614823,11483695
2023-03-15,11527079,43186,25,0,188,869064,-868876,10614829,11483705
2023-03-16,11527099,43186,20,0,198,869078,-868880,10614835,11483715
2023-03-17,11527110,43186,11,0,205,869083,-868878,10614841,11483719
2023-03-18,11527116,43186,6,0,199,869083,-868884,10614847,11483731
2023-03-19,11527139,43186,23,0,213,869096,-868883,10614857,11483740
2023-03-20,11527146,43186,7,0,209,869103,-868894,10614857,11483751
2023-03-21,11527157,43186,11,0,207,869110,-868903,10614861,11483764
2023-03-22,11527175,43186,18,0,213,869114,-868901,10614875,11483776
2023-03-23,11527187,43186,12,0,221,869115,-868894,10614886,11483780
2023-03-24,11527195,43186,8,0,229,869113,-868884,10614896,11483780
2023-03-25,11527203,43186,8,0,217,869118,-868901,10614899,11483800
2023-03-26,11527210,43186,7,0,216,869125,-868909,10614899,11483808
2023-03-27,11527220,43186,10,0,208,869091,-868883,10614943,11483826
2023-03-28,11527236,43186,16,0,210,869104,-868894,10614946,11483840
2023-03-29,11527255,43186,19,0,222,869118,-868896,10614951,11483847
2023-03-30,11527285,43186,30,0,248,869143,-868895,10614956,11483851
2023-03-31,11527301,43186,16,0,255,869149,-868894,10614966,11483860
2023-04-01,11527316,43186,15,0,262,869153,-868891,10614977,11483868
2023-04-02,11527326,43186,10,0,247,869152,-868905,10614988,11483893
2023-04-03,11527366,43186,40,0,267,869192,-868925,10614988,11483913
2023-04-04,11527403,43186,37,0,293,869226,-868933,10614991,11483924
2023-04-05,11527454,43186,51,0,338,869254,-868916,10615014,11483930
2023-04-06,11527497,43186,43,0,358,869283,-868925,10615028,11483953
2023-04-07,11527579,43186,82,0,433,869361,-868928,10615032,11483960
2023-04-08,11527701,43186,122,0,544,869462,-868918,10615053,11483971
2023-04-09,11527745,43186,44,0,570,869480,-868910,10615079,11483989
2023-04-10,11527859,43186,114,0,672,869575,-868903,10615098,11484001
2023-04-11,11528042,43186,183,0,847,869722,-868875,10615134,11484009
2023-04-12,11528303,43186,261,0,1100,869937,-868837,10615180,11484017
2023-04-13,11528800,43186,497,0,1590,870397,-868807,10615217,11484024
2023-04-14,11529581,43186,781,0,2361,871074,-868713,10615321,11484034
2023-04-15,11530356,43186,775,0,3120,871827,-868707,10615343,11484050
2023-04-16,11531072,43186,716,0,3817,872493,-868676,10615393,11484069
2023-04-17,11532103,43186,1031,0,4818,873522,-868704,10615395,11484099
2023-04-18,11533625,43186,1522,0,6324,874906,-868582,10615533,11484115
2023-04-19,11535787,43186,2162,0,8471,876859,-868388,10615742,11484130
2023-04-20,11538248,43186,2461,0,10922,879075,-868153,10615987,11484140
2023-04-21,11540722,43186,2474,0,13356,881343,-867987,10616193,11484180
2023-04-22,11543059,43187,2337,1,15655,883147,-867492,10616725,11484217
2023-04-23,11544777,43187,1718,0,17323,884498,-867175,10617092,11484267
2023-04-24,11546685,43187,1908,0,19188,886179,-866991,10617319,11484310
2023-04-25,11549186,43188,2501,1,21606,887860,-866254,10618138,11484392
2023-04-26,11551917,43188,2731,0,24216,889978,-865762,10618751,11484513
2023-04-27,11554875,43188,2958,0,27130,891874,-864744,10619813,11484557
2023-04-28,11557969,43188,3094,0,30110,894205,-864095,10620576,11484671
2023-04-29,11559862,43188,1893,0,31820,895201,-863381,10621473,11484854
2023-04-30,11561848,43191,1986,3,33542,896530,-862988,10622127,11485115
2023-05-01,11563091,43191,1243,0,34291,897156,-862865,10622744,11485609
2023-05-02,11564293,43195,1202,4,34708,897607,-862899,10623491,11486390
2023-05-03,11565495,43195,1202,0,35139,898268,-863129,10624032,11487161
2023-05-04,11567728,43195,2233,0,36656,899692,-863036,10624841,11487877
2023-05-05,11571127,43196,3399,1,39023,902093,-863070,10625838,11488908
2023-05-06,11573931,43196,2804,0,40306,904211,-863905,10626524,11490429
2023-05-07,11575883,43196,1952,0,40096,905425,-865329,10627262,11492591
2023-05-08,11577938,43197,2055,1,39689,907005,-867316,10627736,11495052
2023-05-09,11580060,43197,2122,0,39338,908185,-868847,10628678,11497525
2023-05-10,11582567,43198,2507,1,39507,910034,-870527,10629335,11499862
2023-05-11,11585390,43200,2823,2,40611,911930,-871319,10630260,11501579
2023-05-12,11587829,43201,2439,1,41143,913404,-872261,10631224,11503485
2023-05-13,11589567,43201,1738,0,40381,914317,-873936,10632049,11505985
2023-05-14,11590617,43201,1050,0,38700,915082,-876382,10632334,11508716
2023-05-15,11592604,43201,1987,0,37729,916827,-879098,10632576,11511674
2023-05-16,11594619,43201,2015,0,36650,918567,-881917,10632851,11514768
2023-05-17,11596662,43201,2043,0,36800,919757,-882957,10633704,11516661
2023-05-18,11598589,43201,1927,0,36741,921215,-884474,10634173,11518647
2023-05-19,11600569,43201,1980,0,37478,922753,-885275,10634615,11519890
2023-05-20,11601759,43202,1190,1,37465,923640,-886175,10634917,11521092
2023-05-21,11602738,43203,979,1,37242,924470,-887228,10635065,11522293
2023-05-22,11603960,43204,1222,1,36231,925387,-889156,10635369,11524525
2023-05-23,11605398,43205,1438,1,34270,926281,-892011,10635912,11527923
2023-05-24,11606479,43205,1081,0,32548,926840,-894292,10636434,11530726
2023-05-25,11607654,43206,1175,1,31770,927575,-895805,10636873,11532678
2023-05-26,11608697,43206,1043,0,30759,928353,-897594,10637138,11534732
2023-05-27,11609537,43206,840,0,29477,928995,-899518,10637336,11536854
2023-05-28,11609878,43206,341,0,27311,929149,-901838,10637523,11539361
2023-05-29,11610724,43206,846,0,25334,929864,-904530,10637654,11542184
2023-05-30,11611376,43206,652,0,23547,930243,-906696,10637927,11544623
2023-05-31,11612608,43206,1232,0,23041,931234,-908193,10638168,11546361
2023-06-01,11613559,43206,951,0,22942,931983,-909041,10638370,11547411
2023-06-02,11614303,43206,744,0,21699,932548,-910849,10638549,11549398
2023-06-03,11614583,43206,280,0,19964,932614,-912650,10638763,11551413
2023-06-04,11615051,43206,468,0,18389,933034,-914645,10638811,11553456
2023-06-05,11615377,43206,326,0,16788,933297,-916509,10638874,11555383
2023-06-06,11616127,43206,750,0,15558,933943,-918385,10638978,11557363
2023-06-07,11616702,43206,575,0,14943,934421,-919478,10639075,11558553
2023-06-08,11617220,43206,518,0,14482,934834,-920352,10639180,11559532
2023-06-09,11617497,43206,277,0,13537,935021,-921484,10639270,11560754
2023-06-10,11617699,43206,202,0,12301,935154,-922853,10639339,11562192
2023-06-11,11617814,43206,115,0,11335,935200,-923865,10639408,11563273
2023-06-12,11617985,43206,171,0,10331,935332,-925001,10639447,11564448
2023-06-13,11618184,43206,199,0,9487,935477,-925990,10639501,11565491
2023-06-14,11618422,43206,238,0,8885,935575,-926690,10639641,11566331
2023-06-15,11618751,43206,329,0,8873,935877,-927004,10639668,11566672
2023-06-16,11619016,43206,265,0,8292,936092,-927800,10639718,11567518
2023-06-17,11619267,43206,251,0,7891,936288,-928397,10639773,11568170
2023-06-18,11619322,43206,55,0,6714,936311,-929597,10639805,11569402
2023-06-19,11619451,43206,129,0,5892,936426,-930534,10639819,11570353
2023-06-20,11619588,43206,137,0,5285,936525,-931240,10639857,11571097
2023-06-21,11619703,43206,115,0,5120,936617,-931497,10639880,11571377
2023-06-22,11619843,43206,140,0,4792,936713,-931921,10639924,11571845
2023-06-23,11619990,43206,147,0,4613,936822,-932209,10639962,11572171
2023-06-24,11620047,43206,57,0,3920,936871,-932951,10639970,11572921
2023-06-25,11620076,43206,29,0,3374,936897,-933523,10639973,11573496
2023-06-26,11620189,43206,113,0,2969,936997,-934028,10639986,11574014
2023-06-27,11620264,43206,75,0,2767,937035,-934268,10640023,11574291
2023-06-28,11620389,43206,125,0,2690,937134,-934444,10640049,11574493
2023-06-29,11620482,43206,93,0,2668,937211,-934543,10640065,11574608
2023-06-30,11620561,43206,79,0,2576,937280,-934704,10640075,11574779
2023-07-01,11620596,43206,35,0,2412,937296,-934884,10640094,11574978
2023-07-02,11620623,43206,27,0,2201,937315,-935114,10640102,11575216
2023-07-03,11620708,43206,85,0,1957,937398,-935441,10640104,11575545
2023-07-04,11620769,43206,61,0,1753,937441,-935688,10640122,11575810
2023-07-05,11620833,43206,64,0,1566,937489,-935923,10640138,11576061
2023-07-06,11620890,43206,57,0,1568,937535,-935967,10640149,11576116
2023-07-07,11620947,43206,57,0,1496,937577,-936081,10640164,11576245
2023-07-08,11621033,43206,86,0,1445,937648,-936203,10640179,11576382
2023-07-09,11621057,43206,24,0,1354,937657,-936303,10640194,11576497
2023-07-10,11621096,43206,39,0,1253,937693,-936440,10640197,11576637
2023-07-11,11621143,43206,47,0,1153,937735,-936582,10640202,11576784
2023-07-12,11621192,43206,49,0,1145,937771,-936626,10640215,11576841
2023-07-13,11621228,43206,36,0,1152,937796,-936644,10640226,11576870
2023-07-14,11621288,43206,60,0,1099,937851,-936752,10640231,11576983
2023-07-15,11621320,43206,32,0,1056,937876,-936820,10640238,11577058
2023-07-16,11621347,43206,27,0,958,937898,-936940,10640243,11577183
2023-07-17,11621397,43206,50,0,915,937937,-937022,10640254,11577276
2023-07-18,11621426,43206,29,0,865,937955,-937090,10640265,11577355
2023-07-19,11621489,43206,63,0,893,938012,-937119,10640271,11577390
2023-07-20,11621522,43206,33,0,899,938033,-937134,10640283,11577417
2023-07-21,11621558,43206,36,0,850,938063,-937213,10640289,11577502
2023-07-22,11621599,43206,41,0,830,938094,-937264,10640299,11577563
2023-07-23,11621626,43206,27,0,793,938118,-937325,10640302,11577627
2023-07-24,11621681,43206,55,0,791,938171,-937380,10640304,11577684
2023-07-25,11621708,43206,27,0,761,938194,-937433,10640308,11577741
2023-07-26,11621728,43206,20,0,695,938211,-937516,10640311,11577827
2023-07-27,11621752,43206,24,0,695,938228,-937533,10640318,11577851
2023-07-28,11621789,43206,37,0,693,938261,-937568,10640322,11577890
2023-07-29,11621798,43206,9,0,655,938270,-937615,10640322,11577937
2023-07-30,11621812,43206,14,0,620,938276,-937656,10640330,11577986
2023-07-31,11621840,43206,28,0,612,938303,-937691,10640331,11578022
2023-08-01,11621883,43206,43,0,595,938342,-937747,10640335,11578082
2023-08-02,11621909,43206,26,0,589,938358,-937769,10640345,11578114
2023-08-03,11621934,43206,25,0,587,938381,-937794,10640347,11578141
2023-08-04,11621965,43206,31,0,568,938409,-937841,10640350,11578191
2023-08-05,11621978,43206,13,0,552,938415,-937863,10640357,11578220
2023-08-06,11621997,43206,19,0,508,938433,-937925,10640358,11578283
2023-08-07,11622021,43206,24,0,499,938456,-937957,10640359,11578316
2023-08-08,11622053,43206,32,0,495,938480,-937985,10640367,11578352
2023-08-09,11622092,43206,39,0,493,938514,-938021,10640372,11578393
2023-08-10,11622119,43206,27,0,493,938535,-938042,10640378,11578420
2023-08-11,11622178,43206,59,0,497,938591,-938094,10640381,11578475
2023-08-12,11622204,43206,26,0,496,938612,-938116,10640386,11578502
2023-08-13,11622218,43206,14,0,490,938625,-938135,10640387,11578522
2023-08-14,11622238,43206,20,0,486,938644,-938158,10640388,11578546
2023-08-15,11622276,43206,38,0,487,938678,-938191,10640392,11578583
2023-08-16,11622327,43206,51,0,529,938726,-938197,10640395,11578592
2023-08-17,11622366,43206,39,0,554,938760,-938206,10640400,11578606
2023-08-18,11622383,43206,17,0,543,938770,-938227,10640407,11578634
2023-08-19,11622404,43206,21,0,521,938776,-938255,10640422,11578677
2023-08-20,11622419,43206,15,0,510,938786,-938276,10640427,11578703
2023-08-21,11622463,43206,44,0,529,938829,-938300,10640428,11578728
2023-08-22,11622514,43206,51,0,549,938869,-938320,10640439,11578759
2023-08-23,11622564,43206,50,0,586,938915,-938329,10640443,11578772
2023-08-24,11622587,43206,23,0,590,938929,-938339,10640452,11578791
2023-08-25,11622660,43206,73,0,639,938993,-938354,10640461,11578815
2023-08-26,11622683,43206,23,0,630,939004,-938374,10640473,11578847
2023-08-27,11622697,43206,14,0,605,939014,-938409,10640477,11578886
2023-08-28,11622730,43206,33,0,611,939045,-938434,10640479,11578913
2023-08-29,11622769,43206,39,0,591,939066,-938475,10640497,11578972
2023-08-30,11622820,43206,51,0,616,939098,-938482,10640516,11578998
2023-08-31,11622858,43206,38,0,640,939118,-938478,10640534,11579012
2023-09-01,11622900,43206,42,0,662,939147,-938485,10640547,11579032
2023-09-02,11622912,43206,12,0,636,939155,-938519,10640551,11579070
2023-09-03,11622924,43206,12,0,597,939163,-938566,10640555,11579121
2023-09-04,11622943,43206,19,0,577,939179,-938602,10640558,11579160
2023-09-05,11622975,43206,32,0,592,939207,-938615,10640562,11579177
2023-09-06,11623024,43206,49,0,620,939223,-938603,10640595,11579198
2023-09-07,11623056,43206,32,0,637,939238,-938601,10640612,11579213
2023-09-08,11623119,43206,63,0,656,939294,-938638,10640619,11579257
2023-09-09,11623182,43206,63,0,668,939352,-938684,10640624,11579308
2023-09-10,11623187,43206,5,0,623,939345,-938722,10640636,11579358
2023-09-11,11623216,43206,29,0,629,939370,-938741,10640640,11579381
2023-09-12,11623259,43206,43,0,599,939410,-938811,10640643,11579454
2023-09-13,11623288,43206,29,0,605,939419,-938814,10640663,11579477
2023-09-14,11623318,43206,30,0,621,939449,-938828,10640663,11579491
2023-09-15,11623357,43206,39,0,627,939477,-938850,10640674,11579524
2023-09-16,11623372,43206,15,0,603,939481,-938878,10640685,11579563
2023-09-17,11623393,43206,21,0,573,939487,-938914,10640700,11579614
2023-09-18,11623420,43206,27,0,562,939510,-938948,10640704,11579652
2023-09-19,11623461,43206,41,0,561,939544,-938983,10640711,11579694
2023-09-20,11623485,43206,24,0,573,939553,-938980,10640726,11579706
2023-09-21,11623513,43206,28,0,589,939571,-938982,10640736,11579718
2023-09-22,11623560,43206,47,0,617,939613,-938996,10640741,11579737
2023-09-23,11623571,43206,11,0,596,939609,-939013,10640756,11579769
2023-09-24,11623577,43206,6,0,553,939611,-939058,10640760,11579818
2023-09-25,11623605,43206,28,0,549,939634,-939085,10640765,11579850
2023-09-26,11623631,43206,26,0,512,939658,-939146,10640767,11579913
2023-09-27,11623649,43206,18,0,467,939666,-939199,10640777,11579976
2023-09-28,11623667,43206,18,0,480,939678,-939198,10640783,11579981
2023-09-29,11623688,43206,21,0,472,939695,-939223,10640787,11580010
2023-09-30,11623698,43206,10,0,439,939683,-939244,10640809,11580053
2023-10-01,11623707,43206,9,0,419,939686,-939267,10640815,11580082
2023-10-02,11623724,43206,17,0,406,939698,-939292,10640820,11580112
2023-10-03,11623747,43206,23,0,390,939713,-939323,10640828,11580151
2023-10-04,11623774,43206,27,0,402,939724,-939322,10640844,11580166
2023-10-05,11623802,43206,28,0,409,939745,-939336,10640851,11580187
2023-10-06,11623834,43206,32,0,414,939771,-939357,10640857,11580214
2023-10-07,11623845,43206,11,0,384,939777,-939393,10640862,11580255
2023-10-08,11623847,43206,2,0,362,939775,-939413,10640866,11580279
2023-10-09,11623858,43206,11,0,345,939778,-939433,10640874,11580307
2023-10-10,11623894,43206,36,0,334,939813,-939479,10640875,11580354
2023-10-11,11623911,43206,17,0,340,939815,-939475,10640890,11580365
2023-10-12,11623938,43206,27,0,361,939836,-939475,10640896,11580371
2023-10-13,11623976,43206,38,0,371,939869,-939498,10640901,11580399
2023-10-14,11623987,43206,11,0,356,939879,-939523,10640902,11580425
2023-10-15,11624000,43206,13,0,351,939877,-939526,10640917,11580443
2023-10-16,11624025,43206,25,0,358,939902,-939544,10640917,11580461
2023-10-17,11624041,43206,16,0,353,939910,-939557,10640925,11580482
2023-10-18,11624054,43206,13,0,356,939907,-939551,10640941,11580492
2023-10-19,11624065,43206,11,0,358,939906,-939548,10640953,11580501
2023-10-20,11624072,43206,7,0,348,939901,-939553,10640965,11580518
2023-10-21,11624080,43206,8,0,333,939903,-939570,10640971,11580541
2023-10-22,11624080,43206,0,0,306,939903,-939597,10640971,11580568
2023-10-23,11624084,43206,4,0,282,939907,-939625,10640971,11580596
2023-10-24,11624089,43206,5,0,255,939912,-939657,10640971,11580628
2023-10-25,11624095,43206,6,0,250,939918,-939668,10640971,11580639
2023-10-26,11624096,43206,1,0,249,939919,-939670,10640971,11580641
2023-10-27,11624100,43206,4,0,242,939923,-939681,10640971,11580652
2023-10-28,11624100,43206,0,0,206,939923,-939717,10640971,11580688
2023-10-29,11624100,43206,0,0,189,939923,-939734,10640971,11580705
2023-10-30,11624105,43206,5,0,167,939928,-939761,10640971,11580732
2023-10-31,11624114,43206,9,0,138,939937,-939799,10640971,11580770
2023-11-01,11624114,43206,0,0,127,939937,-939810,10640971,11580781
2023-11-02,11624114,43206,0,0,114,939937,-939823,10640971,11580794
2023-11-03,11624114,43206,0,0,89,939937,-939848,10640971,11580819
2023-11-04,11624114,43206,0,0,73,939937,-939864,10640971,11580835
2023-11-05,11624114,43206,0,0,60,939937,-939877,10640971,11580848
2023-11-06,11624114,43206,0,0,49,939937,-939888,10640971,11580859
2023-11-07,11624114,43206,0,0,42,939937,-939895,10640971,11580866
2023-11-08,11624114,43206,0,0,34,939937,-939903,10640971,11580874
2023-11-09,11624114,43206,0,0,34,939937,-939903,10640971,11580874
2023-11-10,11624114,43206,0,0,30,939937,-939907,10640971,11580878
2023-11-11,11624114,43206,0,0,25,939937,-939912,10640971,11580883
2023-11-12,11624114,43206,0,0,19,939937,-939918,10640971,11580889
2023-11-13,11624114,43206,0,0,18,939937,-939919,10640971,11580890
2023-11-14,11624114,43206,0,0,14,939937,-939923,10640971,11580894
2023-11-15,11624114,43206,0,0,14,939937,-939923,10640971,11580894
2023-11-16,11624114,43206,0,0,14,939937,-939923,10640971,11580894
2023-11-17,11624114,43206,0,0,9,939937,-939928,10640971,11580899
2023-11-18,11624114,43206,0,0,0,939937,-939937,10640971,11580908
2023-11-19,11624114,43206,0,0,0,939937,-939937,10640971,11580908
2023-11-20,11624114,43206,0,0,0,939937,-939937,10640971,11580908
2023-11-21,11624114,43206,0,0,0,939937,-939937,10640971,11580908
2023-11-22,11624114,43206,0,0,0,939937,-939937,10640971,11580908
2023-11-23,11624114,43206,0,0,0,939937,-939937,10640971,11580908
2023-11-24,11624114,43206,0,0,0,939937,-939937,10640971,11580908
2023-11-25,11624114,43206,0,0,0,939937,-939937,10640971,11580908
2023-11-26,11624114,43206,0,0,0,939937,-939937,10640971,11580908
2023-11-27,11624114,43206,0,0,0,939937,-939937,10640971,11580908
2023-11-28,11624114,43206,0,0,0,939937,-939937,10640971,11580908
2023-11-29,11624114,43206,0,0,0,939937,-939937,10640971,11580908
2023-11-30,11624114,43206,0,0,0,939937,-939937,10640971,11580908
2023-12-01,11624114,43206,0,0,0,939937,-939937,10640971,11580908
2023-12-02,11624114,43206,0,0,0,939937,-939937,10640971,11580908
2023-12-03,11624114,43206,0,0,0,939937,-939937,10640971,11580908
2023-12-04,11624114,43206,0,0,0,939937,-939937,10640971,11580908
2023-12-05,11624114,43206,0,0,0,939937,-939937,10640971,11580908
2023-12-06,11624114,43206,0,0,0,939937,-939937,10640971,11580908
2023-12-07,11624114,43206,0,0,0,939937,-939937,10640971,11580908
2023-12-08,11624114,43206,0,0,0,939937,-939937,10640971,11580908
2023-12-09,11624114,43206,0,0,0,939937,-939937,10640971,11580908
2023-12-10,11624114,43206,0,0,0,939937,-939937,10640971,11580908
2023-12-11,11624114,43206,0,0,0,939937,-939937,10640971,11580908
2023-12-12,11624114,43206,0,0,0,939937,-939937,10640971,11580908
2023-12-13,11624114,43206,0,0,0,939937,-939937,10640971,11580908
2023-12-14,11624114,43206,0,0,0,939937,-939937,10640971,11580908
2023-12-15,11624114,43206,0,0,0,939937,-939937,10640971,11580908
2023-12-16,11624114,43206,0,0,0,939937,-939937,10640971,11580908
2023-12-17,11624114,43206,0,0,0,939937,-939937,10640971,11580908
2023-12-18,11624114,43206,0,0,0,939937,-939937,10640971,11580908
2023-12-19,11624114,43206,0,0,0,939937,-939937,10640971,11580908
2023-12-20,11624114,43206,0,0,0,939937,-939937,10640971,11580908
2023-12-21,11624114,43206,0,0,0,939937,-939937,10640971,11580908
2023-12-22,11624114,43206,0,0,0,939937,-939937,10640971,11580908
2023-12-23,11624114,43206,0,0,0,939937,-939937,10640971,11580908
