Date,Cases,Deaths,Daily cases,Daily deaths,Active cases (new),Active cases (old),Change in active cases,Recoveries (old),Recoveries (new)
15/2/2020,16,0,,,9,9,0,7,7
16/2/2020,16,0,0,0,9,9,0,7,7
17/2/2020,16,0,0,0,9,9,0,7,7
18/2/2020,16,0,0,0,9,9,0,7,7
19/2/2020,16,0,0,0,2,2,0,14,14
20/2/2020,16,0,0,0,2,2,0,14,14
21/2/2020,16,0,0,0,1,1,0,15,15
22/2/2020,16,0,0,0,1,1,0,15,15
23/2/2020,16,0,0,0,1,1,0,15,15
24/2/2020,16,0,0,0,1,1,0,15,15
25/2/2020,16,0,0,0,0,0,0,16,16
26/2/2020,16,0,0,0,0,0,0,16,16
27/2/2020,16,0,0,0,0,0,0,16,16
28/2/2020,16,0,0,0,0,0,0,16,16
29/2/2020,16,0,0,0,0,0,0,16,16
1/3/2020,16,0,0,0,0,0,0,16,16
2/3/2020,16,0,0,0,0,0,0,16,16
3/3/2020,16,0,0,0,0,0,0,16,16
4/3/2020,16,0,0,0,0,0,0,16,16
5/3/2020,16,0,0,0,0,0,0,16,16
6/3/2020,17,0,1,0,1,1,0,16,16
7/3/2020,20,0,3,0,4,4,0,16,16
8/3/2020,31,0,11,0,14,15,-1,16,17
9/3/2020,32,0,1,0,15,16,-1,16,17
10/3/2020,35,0,3,0,18,19,-1,16,17
11/3/2020,40,0,5,0,23,24,-1,16,17
12/3/2020,45,0,5,0,28,29,-1,16,17
13/3/2020,45,0,0,0,28,29,-1,16,17
14/3/2020,54,0,9,0,37,38,-1,16,17
15/3/2020,58,0,4,0,41,42,-1,16,17
16/3/2020,62,0,4,0,45,46,-1,16,17
17/3/2020,67,0,5,0,50,51,-1,16,17
18/3/2020,78,0,11,0,60,62,-2,16,18
19/3/2020,87,0,9,0,69,71,-2,16,18
20/3/2020,93,0,6,0,74,76,-2,17,19
21/3/2020,96,0,3,0,77,79,-2,17,19
22/3/2020,119,0,23,0,96,102,-6,17,23
23/3/2020,130,0,11,0,106,113,-7,17,24
24/3/2020,142,0,12,0,117,125,-8,17,25
25/3/2020,159,0,17,0,131,142,-11,17,28
26/3/2020,164,0,5,0,133,144,-11,20,31
27/3/2020,175,0,11,0,143,155,-12,20,32
28/3/2020,187,0,12,0,153,166,-13,21,34
29/3/2020,212,0,25,0,169,187,-18,25,43
30/3/2020,223,0,11,0,149,168,-19,55,74
31/3/2020,231,0,8,0,154,173,-19,58,77
1/4/2020,237,0,6,0,155,174,-19,63,82
2/4/2020,255,0,18,0,158,180,-22,75,97
3/4/2020,261,0,6,0,154,176,-22,85,107
4/4/2020,262,0,1,0,150,172,-22,90,112
5/4/2020,263,0,1,0,151,173,-22,90,112
6/4/2020,267,0,4,0,150,172,-22,95,117
7/4/2020,273,0,6,0,128,150,-22,123,145
8/4/2020,273,0,0,0,125,147,-22,126,148
9/4/2020,277,0,4,0,127,149,-22,128,150
10/4/2020,279,0,2,0,113,135,-22,144,166
11/4/2020,280,0,1,0,114,136,-22,144,166
12/4/2020,284,0,4,0,118,140,-22,144,166
13/4/2020,287,0,3,0,119,141,-22,146,168
14/4/2020,288,0,1,0,97,119,-22,169,191
15/4/2020,290,0,2,0,97,119,-22,171,193
16/4/2020,290,0,0,0,91,113,-22,177,199
17/4/2020,290,0,0,0,70,92,-22,198,220
18/4/2020,290,0,0,0,67,89,-22,201,223
19/4/2020,290,0,0,0,66,88,-22,202,224
20/4/2020,290,0,0,0,54,76,-22,214,236
21/4/2020,290,0,0,0,52,74,-22,216,238
22/4/2020,290,0,0,0,45,74,-29,216,245
23/4/2020,290,0,0,0,44,74,-30,216,246
24/4/2020,292,0,2,0,50,72,-22,220,242
25/4/2020,292,0,0,0,45,72,-27,220,247
26/4/2020,292,0,0,0,45,72,-27,220,247
27/4/2020,292,0,0,0,45,72,-27,220,247
28/4/2020,292,0,0,0,45,72,-27,220,247
29/4/2020,292,0,0,0,48,70,-22,222,244
30/4/2020,292,0,0,0,51,70,-19,222,241
1/5/2020,292,0,0,0,51,70,-19,222,241
2/5/2020,292,0,0,0,51,70,-19,222,241
3/5/2020,293,0,1,0,52,71,-19,222,241
4/5/2020,293,0,0,0,52,71,-19,222,241
5/5/2020,293,0,0,0,39,61,-22,232,254
6/5/2020,293,0,0,0,39,61,-22,232,254
7/5/2020,313,0,20,0,55,80,-25,233,258
8/5/2020,313,0,0,0,47,72,-25,241,266
9/5/2020,313,0,0,0,47,72,-25,241,266
10/5/2020,313,0,0,0,47,72,-25,241,266
11/5/2020,313,0,0,0,39,64,-25,249,274
12/5/2020,313,0,0,0,36,61,-25,252,277
13/5/2020,313,0,0,0,36,61,-25,252,277
14/5/2020,344,0,31,0,52,84,-32,260,292
15/5/2020,346,0,2,0,54,86,-32,260,292
16/5/2020,350,0,4,0,58,90,-32,260,292
17/5/2020,352,0,2,0,60,92,-32,260,292
18/5/2020,356,0,4,0,61,93,-32,263,295
19/5/2020,356,0,0,0,61,93,-32,263,295
20/5/2020,356,0,0,0,61,93,-32,263,295
21/5/2020,356,0,0,0,60,92,-32,264,296
22/5/2020,356,0,0,0,57,89,-32,267,299
23/5/2020,356,0,0,0,57,89,-32,267,299
24/5/2020,357,0,1,0,58,90,-32,267,299
25/5/2020,358,0,1,0,54,86,-32,272,304
26/5/2020,359,0,1,0,55,87,-32,272,304
27/5/2020,359,0,0,0,49,81,-32,278,310
28/5/2020,359,0,0,0,49,81,-32,278,310
29/5/2020,359,0,0,0,48,80,-32,279,311
30/5/2020,360,0,1,0,49,81,-32,279,311
31/5/2020,360,0,0,0,49,81,-32,279,311
1/6/2020,360,0,0,0,35,67,-32,293,325
2/6/2020,360,0,0,0,30,62,-32,298,330
3/6/2020,360,0,0,0,26,58,-32,302,334
4/6/2020,360,0,0,0,26,58,-32,302,334
5/6/2020,360,0,0,0,21,53,-32,307,339
6/6/2020,361,0,1,0,22,54,-32,307,339
7/6/2020,361,0,0,0,22,54,-32,307,339
8/6/2020,364,0,3,0,16,48,-32,316,348
9/6/2020,364,0,0,0,16,48,-32,316,348
10/6/2020,364,0,0,0,12,44,-32,320,352
11/6/2020,364,0,0,0,11,43,-32,321,353
12/6/2020,365,0,1,0,10,42,-32,323,355
13/6/2020,366,0,1,0,11,43,-32,323,355
14/6/2020,366,0,0,0,11,43,-32,323,355
15/6/2020,366,0,0,0,11,43,-32,323,355
16/6/2020,366,0,0,0,9,41,-32,325,357
17/6/2020,367,0,1,0,10,42,-32,325,357
18/6/2020,374,0,7,0,17,49,-32,325,357
19/6/2020,381,0,7,0,23,55,-32,326,358
20/6/2020,381,0,0,0,22,54,-32,327,359
21/6/2020,381,0,0,0,22,54,-32,327,359
22/6/2020,381,0,0,0,21,53,-32,328,360
23/6/2020,381,0,0,0,20,52,-32,329,361
24/6/2020,384,0,3,0,23,55,-32,329,361
25/6/2020,384,0,0,0,23,55,-32,329,361
26/6/2020,385,0,1,0,23,55,-32,330,362
27/6/2020,387,0,2,0,25,57,-32,330,362
28/6/2020,387,0,0,0,25,57,-32,330,362
29/6/2020,387,0,0,0,20,52,-32,335,367
30/6/2020,387,0,0,0,20,52,-32,335,367
1/7/2020,387,0,0,0,19,51,-32,336,368
2/7/2020,387,0,0,0,15,47,-32,340,372
3/7/2020,387,0,0,0,15,47,-32,340,372
4/7/2020,387,0,0,0,15,47,-32,340,372
5/7/2020,387,0,0,0,15,47,-32,340,372
6/7/2020,404,0,17,0,28,63,-35,341,376
7/7/2020,404,0,0,0,27,62,-35,342,377
8/7/2020,404,0,0,0,22,57,-35,347,382
9/7/2020,404,0,0,0,22,57,-35,347,382
10/7/2020,404,0,0,0,19,54,-35,350,385
11/7/2020,405,0,1,0,20,55,-35,350,385
12/7/2020,407,0,2,0,22,57,-35,350,385
13/7/2020,407,0,0,0,22,57,-35,350,385
14/7/2020,408,0,1,0,21,56,-35,352,387
15/7/2020,416,0,8,0,28,63,-35,353,388
16/7/2020,416,0,0,0,25,60,-35,356,391
17/7/2020,417,0,1,0,26,61,-35,356,391
18/7/2020,417,0,0,0,25,60,-35,357,392
19/7/2020,418,0,1,0,26,61,-35,357,392
20/7/2020,419,0,1,0,24,59,-35,360,395
21/7/2020,439,0,20,0,36,74,-38,365,403
22/7/2020,446,0,7,0,43,81,-38,365,403
23/7/2020,450,0,4,0,47,85,-38,365,403
24/7/2020,451,0,1,0,48,86,-38,365,403
25/7/2020,455,0,4,0,52,90,-38,365,403
26/7/2020,458,0,3,0,55,93,-38,365,403
27/7/2020,470,0,12,0,66,105,-39,365,404
28/7/2020,488,0,18,0,77,119,-42,369,411
29/7/2020,504,0,16,0,90,135,-45,369,414
30/7/2020,578,0,74,0,140,209,-69,369,438
31/7/2020,631,2,53,2,171,256,-85,373,458
1/8/2020,697,3,66,1,214,321,-107,373,480
2/8/2020,738,6,41,3,241,359,-118,373,491
3/8/2020,784,6,46,0,272,404,-132,374,506
4/8/2020,809,8,25,2,286,423,-137,378,515
5/8/2020,877,8,68,0,328,488,-160,381,541
6/8/2020,918,10,41,2,345,516,-171,392,563
7/8/2020,981,10,63,0,384,576,-192,395,587
8/8/2020,1011,10,30,0,407,606,-199,395,594
9/8/2020,1051,11,40,1,435,645,-210,395,605
10/8/2020,1057,15,6,4,433,643,-210,399,609
11/8/2020,1080,16,23,1,451,665,-214,399,613
12/8/2020,1100,17,20,1,457,674,-217,409,626
13/8/2020,1139,21,39,4,465,693,-228,425,653
14/8/2020,1162,22,23,1,471,703,-232,437,669
15/8/2020,1188,23,26,1,481,718,-237,447,684
16/8/2020,1200,24,12,1,482,720,-238,456,694
17/8/2020,1226,24,26,0,492,735,-243,467,710
18/8/2020,1232,25,6,1,438,681,-243,526,769
19/8/2020,1237,25,5,0,436,679,-243,533,776
20/8/2020,1253,25,16,0,440,686,-246,542,788
21/8/2020,1255,25,2,0,439,685,-246,545,791
22/8/2020,1260,26,5,1,425,671,-246,563,809
23/8/2020,1262,27,2,1,426,672,-246,563,809
24/8/2020,1268,27,6,0,408,654,-246,587,833
25/8/2020,1275,27,7,0,410,656,-246,592,838
26/8/2020,1280,29,5,2,373,619,-246,632,878
27/8/2020,1282,30,2,1,369,615,-246,637,883
28/8/2020,1284,30,2,0,345,591,-246,663,909
29/8/2020,1286,32,2,2,331,577,-246,677,923
30/8/2020,1286,32,0,0,313,559,-246,695,941
31/8/2020,1290,34,4,2,303,549,-246,707,953
1/9/2020,1290,34,0,0,275,521,-246,735,981
2/9/2020,1292,34,2,0,266,512,-246,746,992
3/9/2020,1292,35,0,1,256,502,-246,755,1001
4/9/2020,1295,35,3,0,242,488,-246,772,1018
5/9/2020,1295,35,0,0,209,455,-246,805,1051
6/9/2020,1295,35,0,0,199,445,-246,815,1061
7/9/2020,1295,35,0,0,161,407,-246,853,1099
8/9/2020,1300,35,5,0,151,397,-246,868,1114
9/9/2020,1305,35,5,0,134,380,-246,890,1136
10/9/2020,1305,35,0,0,131,377,-246,893,1139
11/9/2020,1306,35,1,0,123,369,-246,902,1148
12/9/2020,1306,35,0,0,115,361,-246,910,1156
13/9/2020,1309,35,3,0,110,356,-246,918,1164
14/9/2020,1309,35,0,0,102,348,-246,926,1172
15/9/2020,1309,35,0,0,97,343,-246,931,1177
16/9/2020,1309,35,0,0,92,338,-246,936,1182
17/9/2020,1312,35,3,0,91,337,-246,940,1186
18/9/2020,1314,35,2,0,92,338,-246,941,1187
19/9/2020,1314,35,0,0,91,337,-246,942,1188
20/9/2020,1314,35,0,0,91,337,-246,942,1188
21/9/2020,1314,35,0,0,86,332,-246,947,1193
22/9/2020,1314,35,0,0,76,322,-246,957,1203
23/9/2020,1315,35,1,0,43,289,-246,991,1237
24/9/2020,1315,35,0,0,43,289,-246,991,1237
25/9/2020,1315,35,0,0,35,281,-246,999,1245
26/9/2020,1315,35,0,0,35,281,-246,999,1245
27/9/2020,1320,35,5,0,40,286,-246,999,1245
28/9/2020,1323,35,3,0,43,289,-246,999,1245
29/9/2020,1343,35,20,0,52,301,-249,1007,1256
30/9/2020,1343,35,0,0,49,298,-249,1010,1259
1/10/2020,1344,35,1,0,50,299,-249,1010,1259
2/10/2020,1345,35,1,0,41,290,-249,1020,1269
3/10/2020,1345,35,0,0,41,290,-249,1020,1269
4/10/2020,1345,35,0,0,41,290,-249,1020,1269
5/10/2020,1346,35,1,0,40,289,-249,1022,1271
6/10/2020,1347,35,1,0,40,289,-249,1023,1272
7/10/2020,1348,35,1,0,41,290,-249,1023,1272
8/10/2020,1349,35,1,0,42,291,-249,1023,1272
9/10/2020,1354,35,5,0,46,295,-249,1024,1273
10/10/2020,1356,35,2,0,48,297,-249,1024,1273
11/10/2020,1358,35,2,0,50,299,-249,1024,1273
12/10/2020,1359,35,1,0,50,299,-249,1025,1274
13/10/2020,1362,35,3,0,53,302,-249,1025,1274
14/10/2020,1371,35,9,0,58,307,-249,1029,1278
15/10/2020,1373,35,2,0,59,308,-249,1030,1279
16/10/2020,1373,35,0,0,58,307,-249,1031,1280
17/10/2020,1375,35,2,0,60,309,-249,1031,1280
18/10/2020,1383,35,8,0,68,317,-249,1031,1280
19/10/2020,1389,35,6,0,59,308,-249,1046,1295
20/10/2020,1390,35,1,0,60,309,-249,1046,1295
21/10/2020,1393,35,3,0,63,312,-249,1046,1295
22/10/2020,1397,35,4,0,64,313,-249,1049,1298
23/10/2020,1397,35,0,0,64,313,-249,1049,1298
24/10/2020,1410,35,13,0,74,324,-250,1051,1301
25/10/2020,1418,35,8,0,76,326,-250,1057,1307
26/10/2020,1419,35,1,0,73,323,-250,1061,1311
27/10/2020,1422,35,3,0,75,325,-250,1062,1312
28/10/2020,1423,35,1,0,76,326,-250,1062,1312
29/10/2020,1427,35,4,0,80,330,-250,1062,1312
30/10/2020,1427,35,0,0,80,330,-250,1062,1312
31/10/2020,1430,35,3,0,83,333,-250,1062,1312
1/11/2020,1430,35,0,0,82,332,-250,1063,1313
2/11/2020,1443,35,13,0,92,343,-251,1065,1316
3/11/2020,1454,35,11,0,98,350,-252,1069,1321
4/11/2020,1455,35,1,0,99,351,-252,1069,1321
5/11/2020,1459,35,4,0,103,355,-252,1069,1321
6/11/2020,1464,35,5,0,107,359,-252,1070,1322
7/11/2020,1465,35,1,0,108,360,-252,1070,1322
8/11/2020,1465,35,0,0,108,360,-252,1070,1322
9/11/2020,1467,35,2,0,93,345,-252,1087,1339
10/11/2020,1479,35,12,0,104,357,-253,1087,1340
11/11/2020,1512,35,33,0,130,390,-260,1087,1347
12/11/2020,1513,35,1,0,125,385,-260,1093,1353
13/11/2020,1516,35,3,0,120,380,-260,1101,1361
14/11/2020,1516,35,0,0,118,378,-260,1103,1363
15/11/2020,1548,35,32,0,143,410,-267,1103,1370
16/11/2020,1550,35,2,0,124,391,-267,1124,1391
17/11/2020,1555,35,5,0,129,396,-267,1124,1391
18/11/2020,1568,35,13,0,141,409,-268,1124,1392
19/11/2020,1572,35,4,0,127,395,-268,1142,1410
20/11/2020,1573,35,1,0,128,396,-268,1142,1410
21/11/2020,1574,35,1,0,129,397,-268,1142,1410
22/11/2020,1575,35,1,0,130,398,-268,1142,1410
23/11/2020,1580,35,5,0,126,394,-268,1151,1419
24/11/2020,1584,35,4,0,128,396,-268,1153,1421
25/11/2020,1589,35,5,0,133,401,-268,1153,1421
26/11/2020,1600,35,11,0,130,399,-269,1166,1435
27/11/2020,1608,35,8,0,134,403,-269,1170,1439
28/11/2020,1610,35,2,0,127,396,-269,1179,1448
29/11/2020,1612,35,2,0,129,398,-269,1179,1448
30/11/2020,1616,35,4,0,133,402,-269,1179,1448
1/12/2020,1620,35,4,0,121,390,-269,1195,1464
2/12/2020,1627,35,7,0,122,391,-269,1201,1470
3/12/2020,1630,35,3,0,117,386,-269,1209,1478
4/12/2020,1630,35,0,0,106,375,-269,1220,1489
5/12/2020,1634,35,4,0,110,379,-269,1220,1489
6/12/2020,1635,35,1,0,111,380,-269,1220,1489
7/12/2020,1636,35,1,0,108,377,-269,1224,1493
8/12/2020,1647,35,11,0,118,388,-270,1224,1494
9/12/2020,1651,35,4,0,121,391,-270,1225,1495
10/12/2020,1655,35,4,0,125,395,-270,1225,1495
11/12/2020,1661,35,6,0,118,388,-270,1238,1508
12/12/2020,1665,35,4,0,122,392,-270,1238,1508
13/12/2020,1667,35,2,0,121,391,-270,1241,1511
14/12/2020,1672,35,5,0,121,391,-270,1246,1516
15/12/2020,1675,35,3,0,118,388,-270,1252,1522
16/12/2020,1675,35,0,0,118,388,-270,1252,1522
17/12/2020,1677,35,2,0,109,379,-270,1263,1533
18/12/2020,1680,35,3,0,109,379,-270,1266,1536
19/12/2020,1681,35,1,0,107,377,-270,1269,1539
20/12/2020,1683,35,2,0,109,379,-270,1269,1539
21/12/2020,1684,35,1,0,110,380,-270,1269,1539
22/12/2020,1690,35,6,0,104,374,-270,1281,1551
23/12/2020,1691,35,1,0,105,375,-270,1281,1551
24/12/2020,1703,35,12,0,116,387,-271,1281,1552
25/12/2020,1710,35,7,0,101,372,-271,1303,1574
26/12/2020,1711,35,1,0,102,373,-271,1303,1574
27/12/2020,1712,35,1,0,103,374,-271,1303,1574
28/12/2020,1723,35,11,0,113,385,-272,1303,1575
29/12/2020,1726,35,3,0,100,372,-272,1319,1591
30/12/2020,1728,35,2,0,98,370,-272,1323,1595
31/12/2020,1737,35,9,0,105,377,-272,1325,1597
1/1/2021,1746,35,9,0,114,386,-272,1325,1597
2/1/2021,1754,35,8,0,110,382,-272,1337,1609
3/1/2021,1767,35,13,0,120,393,-273,1339,1612
4/1/2021,1770,35,3,0,123,396,-273,1339,1612
5/1/2021,1777,35,7,0,130,403,-273,1339,1612
6/1/2021,1778,35,1,0,117,390,-273,1353,1626
7/1/2021,1782,35,4,0,121,394,-273,1353,1626
8/1/2021,1785,35,3,0,120,393,-273,1357,1630
9/1/2021,1786,35,1,0,117,390,-273,1361,1634
10/1/2021,1787,35,1,0,118,391,-273,1361,1634
11/1/2021,1788,35,1,0,119,392,-273,1361,1634
12/1/2021,1793,35,5,0,124,397,-273,1361,1634
13/1/2021,1794,35,1,0,117,390,-273,1369,1642
14/1/2021,1805,35,11,0,127,401,-274,1369,1643
15/1/2021,1810,35,5,0,121,395,-274,1380,1654
16/1/2021,1811,35,1,0,122,396,-274,1380,1654
17/1/2021,1811,35,0,0,122,396,-274,1380,1654
18/1/2021,1813,35,2,0,102,376,-274,1402,1676
19/1/2021,1814,35,1,0,103,377,-274,1402,1676
20/1/2021,1818,35,4,0,103,377,-274,1406,1680
21/1/2021,1820,35,2,0,100,374,-274,1411,1685
22/1/2021,1822,35,2,0,102,376,-274,1411,1685
23/1/2021,1822,35,0,0,102,376,-274,1411,1685
24/1/2021,1822,35,0,0,102,376,-274,1411,1685
25/1/2021,1823,35,1,0,89,363,-274,1425,1699
26/1/2021,1825,35,2,0,86,360,-274,1430,1704
27/1/2021,1825,35,0,0,86,360,-274,1430,1704
28/1/2021,1972,35,147,0,177,507,-330,1430,1760
29/1/2021,2069,35,97,0,222,586,-364,1448,1812
30/1/2021,2165,35,96,0,276,674,-398,1456,1854
31/1/2021,2239,35,74,0,325,747,-422,1457,1879
1/2/2021,2287,35,48,0,355,792,-437,1460,1897
2/2/2021,2333,35,46,0,387,838,-451,1460,1911
3/2/2021,2373,35,40,0,415,877,-462,1461,1923
4/2/2021,2442,35,69,0,457,942,-485,1465,1950
5/2/2021,2465,35,23,0,476,965,-489,1465,1954
6/2/2021,2470,35,5,0,478,967,-489,1468,1957
7/2/2021,2495,35,25,0,494,988,-494,1472,1966
8/2/2021,2568,35,73,0,543,1061,-518,1472,1990
9/2/2021,2585,35,17,0,557,1078,-521,1472,1993
10/2/2021,2621,35,36,0,576,1106,-530,1480,2010
11/2/2021,2694,35,73,0,577,1131,-554,1528,2082
12/2/2021,2696,35,2,0,578,1132,-554,1529,2083
13/2/2021,2774,35,78,0,631,1210,-579,1529,2108
14/2/2021,2822,35,48,0,661,1255,-594,1532,2126
15/2/2021,2884,35,62,0,693,1308,-615,1541,2156
16/2/2021,2947,35,63,0,703,1339,-636,1573,2209
17/2/2021,2968,35,21,0,720,1359,-639,1574,2213
18/2/2021,2989,35,21,0,707,1349,-642,1605,2247
19/2/2021,3007,35,18,0,700,1345,-645,1627,2272
20/2/2021,3013,35,6,0,706,1351,-645,1627,2272
21/2/2021,3031,35,18,0,646,1294,-648,1702,2350
22/2/2021,3040,35,9,0,640,1288,-648,1717,2365
23/2/2021,3049,35,9,0,649,1297,-648,1717,2365
24/2/2021,3061,35,12,0,587,1236,-649,1790,2439
25/2/2021,3069,35,8,0,581,1230,-649,1804,2453
26/2/2021,3075,35,6,0,552,1201,-649,1839,2488
27/2/2021,3081,35,6,0,553,1202,-649,1844,2493
28/2/2021,3100,35,19,0,537,1189,-652,1876,2528
1/3/2021,3100,35,0,0,537,1189,-652,1876,2528
2/3/2021,3131,35,31,0,539,1198,-659,1898,2557
3/3/2021,3142,35,11,0,549,1209,-660,1898,2558
4/3/2021,3148,35,6,0,533,1193,-660,1920,2580
5/3/2021,3154,35,6,0,539,1199,-660,1920,2580
6/3/2021,3161,35,7,0,546,1206,-660,1920,2580
7/3/2021,3173,35,12,0,557,1218,-661,1920,2581
8/3/2021,3186,35,13,0,569,1231,-662,1920,2582
9/3/2021,3188,35,2,0,487,1149,-662,2004,2666
10/3/2021,3191,35,3,0,490,1152,-662,2004,2666
11/3/2021,3195,35,4,0,450,1112,-662,2048,2710
12/3/2021,3215,35,20,0,429,1094,-665,2086,2751
13/3/2021,3218,35,3,0,432,1097,-665,2086,2751
14/3/2021,3219,35,1,0,433,1098,-665,2086,2751
15/3/2021,3222,35,3,0,407,1072,-665,2115,2780
16/3/2021,3225,35,3,0,367,1032,-665,2158,2823
17/3/2021,3232,35,7,0,334,999,-665,2198,2863
18/3/2021,3235,35,3,0,337,1002,-665,2198,2863
19/3/2021,3236,35,1,0,338,1003,-665,2198,2863
20/3/2021,3237,35,1,0,339,1004,-665,2198,2863
21/3/2021,3237,35,0,0,339,1004,-665,2198,2863
22/3/2021,3240,35,3,0,307,972,-665,2233,2898
23/3/2021,3240,35,0,0,294,959,-665,2246,2911
24/3/2021,3241,35,1,0,276,941,-665,2265,2930
25/3/2021,3244,35,3,0,279,944,-665,2265,2930
26/3/2021,3251,35,7,0,286,951,-665,2265,2930
27/3/2021,3251,35,0,0,243,908,-665,2308,2973
28/3/2021,3256,35,5,0,248,913,-665,2308,2973
29/3/2021,3259,35,3,0,251,916,-665,2308,2973
30/3/2021,3259,35,0,0,200,865,-665,2359,3024
31/3/2021,3268,35,9,0,209,874,-665,2359,3024
1/4/2021,3285,35,17,0,223,891,-668,2359,3027
2/4/2021,3288,35,3,0,202,870,-668,2383,3051
3/4/2021,3294,35,6,0,208,876,-668,2383,3051
4/4/2021,3299,35,5,0,213,881,-668,2383,3051
5/4/2021,3305,35,6,0,186,854,-668,2416,3084
6/4/2021,3317,35,12,0,191,860,-669,2422,3091
7/4/2021,3329,35,12,0,195,865,-670,2429,3099
8/4/2021,3338,35,9,0,204,874,-670,2429,3099
9/4/2021,3356,35,18,0,219,892,-673,2429,3102
10/4/2021,3365,35,9,0,228,901,-673,2429,3102
11/4/2021,3366,35,1,0,229,902,-673,2429,3102
12/4/2021,3379,35,13,0,225,899,-674,2445,3119
13/4/2021,3388,35,9,0,234,908,-674,2445,3119
14/4/2021,3411,35,23,0,253,931,-678,2445,3123
15/4/2021,3443,35,32,0,278,963,-685,2445,3130
16/4/2021,3460,35,17,0,292,980,-688,2445,3133
17/4/2021,3469,35,9,0,271,959,-688,2475,3163
18/4/2021,3472,35,3,0,274,962,-688,2475,3163
19/4/2021,3479,35,7,0,281,969,-688,2475,3163
20/4/2021,3488,35,9,0,275,963,-688,2490,3178
21/4/2021,3494,35,6,0,281,969,-688,2490,3178
22/4/2021,3505,35,11,0,291,980,-689,2490,3179
23/4/2021,3522,35,17,0,305,997,-692,2490,3182
24/4/2021,3525,35,3,0,308,1000,-692,2490,3182
25/4/2021,3536,35,11,0,292,985,-693,2516,3209
26/4/2021,3545,35,9,0,301,994,-693,2516,3209
27/4/2021,3550,35,5,0,306,999,-693,2516,3209
28/4/2021,3558,35,8,0,314,1007,-693,2516,3209
29/4/2021,3626,35,68,0,359,1075,-716,2516,3232
30/4/2021,3647,35,21,0,377,1096,-719,2516,3235
1/5/2021,3664,35,17,0,359,1081,-722,2548,3270
2/5/2021,3689,35,25,0,378,1105,-727,2549,3276
3/5/2021,3712,35,23,0,386,1117,-731,2560,3291
4/5/2021,3730,35,18,0,401,1135,-734,2560,3294
5/5/2021,3763,35,33,0,427,1168,-741,2560,3301
6/5/2021,3870,35,107,0,495,1275,-780,2560,3340
7/5/2021,3941,35,71,0,542,1346,-804,2560,3364
8/5/2021,4091,35,150,0,603,1454,-851,2602,3453
9/5/2021,4259,35,168,0,765,1622,-857,2602,3459
10/5/2021,4475,35,216,0,970,1838,-868,2602,3470
11/5/2021,4598,35,123,0,1076,1945,-869,2618,3487
12/5/2021,4733,35,135,0,1208,2062,-854,2636,3490
13/5/2021,4869,35,136,0,1333,2177,-844,2657,3501
14/5/2021,5044,35,175,0,1499,2352,-853,2657,3510
15/5/2021,5322,36,278,1,1771,2618,-847,2668,3515
16/5/2021,5637,36,315,0,2079,2933,-854,2668,3522
17/5/2021,5940,37,303,1,2313,3235,-922,2668,3590
18/5/2021,6191,37,251,0,2544,3467,-923,2687,3610
19/5/2021,6481,37,290,0,2817,3757,-940,2687,3627
20/5/2021,6680,39,199,2,2989,3954,-965,2687,3652
21/5/2021,6901,41,221,2,3187,4171,-984,2689,3673
22/5/2021,7141,41,240,0,3411,4379,-968,2721,3689
23/5/2021,7361,42,220,1,3597,4598,-1001,2721,3722
24/5/2021,7672,44,311,2,3800,4834,-1034,2794,3828
25/5/2021,8276,44,604,0,4335,5438,-1103,2794,3897
26/5/2021,8792,45,516,1,4700,5894,-1194,2853,4047
27/5/2021,9171,46,379,1,4911,6272,-1361,2853,4214
28/5/2021,9584,47,413,1,5108,6641,-1533,2896,4429
29/5/2021,10053,47,469,0,5455,7110,-1655,2896,4551
30/5/2021,10460,47,407,0,5727,7463,-1736,2950,4686
31/5/2021,10815,47,355,0,5946,7739,-1793,3029,4822
1/6/2021,11222,48,407,1,6177,8131,-1954,3043,4997
2/6/2021,11615,49,393,1,6292,8481,-2189,3085,5274
3/6/2021,12020,49,405,0,6383,8886,-2503,3085,5588
4/6/2021,12392,51,372,2,6450,9099,-2649,3242,5891
5/6/2021,12805,53,413,2,6612,9442,-2830,3310,6140
6/6/2021,13146,53,341,0,6665,9725,-3060,3368,6428
7/6/2021,13533,53,387,0,6853,9971,-3118,3509,6627
8/6/2021,13817,55,284,2,6914,10215,-3301,3547,6848
9/6/2021,14488,55,671,0,7347,10797,-3450,3636,7086
10/6/2021,14853,55,365,0,7492,11090,-3598,3708,7306
11/6/2021,15178,57,325,2,7504,11317,-3813,3804,7617
12/6/2021,15605,58,427,1,7328,11720,-4392,3827,8219
13/6/2021,16091,59,486,1,7298,12034,-4736,3998,8734
14/6/2021,16540,59,449,0,7369,12245,-4876,4236,9112
15/6/2021,17205,61,665,2,7619,12605,-4986,4539,9525
16/6/2021,17901,61,696,0,7848,13250,-5402,4590,9992
17/6/2021,18748,61,847,0,8288,14034,-5746,4653,10399
18/6/2021,19180,62,432,1,8364,14385,-6021,4733,10754
19/6/2021,19976,64,796,2,8752,14858,-6106,5054,11160
20/6/2021,20489,66,513,2,8872,15194,-6322,5229,11551
21/6/2021,20938,69,449,3,8915,15416,-6501,5453,11954
22/6/2021,21334,69,396,0,8942,15719,-6777,5546,12323
23/6/2021,21700,70,366,1,8894,15946,-7052,5684,12736
24/6/2021,22168,72,468,2,9020,16337,-7317,5759,13076
25/6/2021,23595,74,1427,2,10060,17572,-7512,5949,13461
26/6/2021,23879,74,284,0,10062,17668,-7606,6137,13743
27/6/2021,24482,76,603,2,9992,18087,-8095,6319,14414
28/6/2021,25142,76,660,0,10289,18547,-8258,6519,14777
29/6/2021,25752,80,610,4,10570,18908,-8338,6764,15102
30/6/2021,26490,81,738,1,10884,19569,-8685,6840,15525
1/7/2021,27667,81,1177,0,11576,20339,-8763,7247,16010
2/7/2021,28562,84,895,3,12019,21083,-9064,7395,16459
3/7/2021,30081,84,1519,0,12876,22354,-9478,7643,17121
4/7/2021,31549,86,1468,2,13646,23644,-9998,7819,17817
5/7/2021,33361,90,1812,4,14609,25249,-10640,8022,18662
6/7/2021,35059,97,1698,7,15872,26885,-11013,8077,19090
7/7/2021,36716,102,1657,5,16735,28057,-11322,8557,19879
8/7/2021,38883,105,2167,3,18391,29828,-11437,8950,20387
9/7/2021,41562,110,2679,5,20619,32468,-11849,8984,20833
10/7/2021,44614,112,3052,2,23278,35298,-12020,9204,21224
11/7/2021,47833,119,3219,7,26126,38439,-12313,9275,21588
12/7/2021,51759,125,3926,6,29585,42303,-12718,9331,22049
13/7/2021,55553,132,3794,7,31951,45868,-13917,9553,23470
14/7/2021,60390,138,4837,6,36505,50628,-14123,9624,23747
15/7/2021,66025,207,5635,69,41474,56130,-14656,9688,24344
16/7/2021,71525,225,5500,18,46365,61280,-14915,10020,24935
17/7/2021,77651,225,6126,0,51899,67114,-15215,10312,25527
18/7/2021,87428,254,9777,29,60909,76507,-15598,10667,26265
19/7/2021,94350,334,6922,80,66603,82969,-16366,11047,27413
20/7/2021,102263,334,7913,0,73701,90486,-16785,11443,28228
21/7/2021,111104,370,8841,36,80987,98763,-17776,11971,29747
22/7/2021,121317,396,10213,26,89742,107500,-17758,13421,31179
23/7/2021,133371,428,12054,32,99978,117407,-17429,15536,32965
24/7/2021,148639,462,15268,34,113546,130594,-17048,17583,34631
25/7/2021,161066,493,12427,31,124319,141231,-16912,19342,36254
26/7/2021,174068,524,13002,31,135154,152200,-17046,21344,38390
27/7/2021,187121,524,13053,0,145559,163651,-18092,22946,41038
28/7/2021,197938,630,10817,106,153218,169851,-16633,27457,44090
29/7/2021,210459,863,12521,233,162393,177816,-15423,31780,47203
30/7/2021,224723,1162,14264,299,172665,188077,-15412,35484,50896
31/7/2021,238948,1307,14225,145,183250,198907,-15657,38734,54391
1/8/2021,253168,1499,14220,192,192586,208512,-15926,43157,59083
2/8/2021,265464,1696,12296,197,199242,216803,-17561,46965,64526
3/8/2021,279365,2073,13901,377,207463,226461,-18998,50831,69829
4/8/2021,291937,2330,12572,257,214029,235275,-21246,54332,75578
5/8/2021,303885,2724,11948,394,216063,243121,-27058,58040,85098
6/8/2021,317612,3021,13727,297,222965,252259,-29294,62332,91626
7/8/2021,329711,3255,12099,234,227214,259819,-32605,66637,99242
8/8/2021,345698,3402,15987,147,234447,270799,-36352,71497,107849
9/8/2021,361104,3763,15406,361,239426,281421,-41995,75920,117915
10/8/2021,374944,4152,13840,389,241184,290444,-49260,80348,129608
11/8/2021,389400,4495,14456,343,240418,299751,-59333,85154,144487
12/8/2021,405348,4822,15948,327,243955,311381,-67426,89145,156571
13/8/2021,420488,5098,15140,276,246144,322652,-76508,92738,169246
14/8/2021,436517,5448,16029,350,249046,334084,-85038,96985,182023
15/8/2021,452323,5786,15806,338,254047,344033,-89986,102504,192490
16/8/2021,466594,6154,14271,368,255767,353463,-97696,106977,204673
17/8/2021,482440,6486,15846,332,257385,364646,-107261,111308,218569
18/8/2021,496716,6785,14276,299,257469,374872,-117403,115059,232462
19/8/2021,514290,7166,17574,381,260741,387065,-126324,120059,246383
20/8/2021,535363,7557,21073,391,269508,394991,-125483,132815,258298
21/8/2021,554265,7926,18902,369,274531,406252,-131721,140087,271808
22/8/2021,572959,8296,18694,370,280652,416996,-136344,147667,284011
23/8/2021,589918,8686,16959,390,285643,426620,-140977,154612,295589
24/8/2021,607749,9035,17831,349,289788,436439,-146651,162275,308926
25/8/2021,627701,9371,19952,336,297654,448409,-150755,169921,320676
26/8/2021,654233,9690,26532,319,308216,456055,-147839,188488,336327
27/8/2021,675549,10077,21316,387,314058,466858,-152800,198614,351414
28/8/2021,695513,10430,19964,353,320216,474094,-153878,210989,364867
29/8/2021,716625,10775,21112,345,326880,486048,-159168,219802,378970
30/8/2021,740085,11091,23460,316,334421,500178,-165757,228816,394573
31/8/2021,760882,11456,20797,365,340029,510566,-170537,238860,409397
1/9/2021,779744,11896,18862,440,342787,519126,-176339,248722,425061
2/9/2021,801514,12168,21770,272,348919,530022,-181103,259324,440427
3/9/2021,826127,12477,24613,309,359224,542982,-183758,270668,454426
4/9/2021,841831,12825,15704,348,359043,546490,-187447,282516,469963
5/9/2021,863499,13107,21668,282,366501,558665,-192164,291727,483891
6/9/2021,884091,13419,20592,312,369489,569215,-199726,301457,501183
7/9/2021,907527,13736,23436,317,371847,582081,-210234,311710,521944
8/9/2021,928445,14161,20918,425,373755,588637,-214882,325647,540529
9/9/2021,948928,14507,20483,346,375623,596251,-220628,338170,558798
10/9/2021,970900,14783,21972,276,380706,605196,-224490,350921,575411
11/9/2021,990585,15057,19685,274,382562,612066,-229504,363462,592966
12/9/2021,1010429,15319,19844,262,382466,620532,-238066,374578,612644
13/9/2021,1028861,15701,18432,382,374246,627382,-253136,385778,638914
14/9/2021,1046198,15978,17337,277,370372,631759,-261387,398461,659848
15/9/2021,1063659,16229,17461,251,367895,634780,-266885,412650,679535
16/9/2021,1080963,16468,17304,239,364099,640944,-276845,423551,700396
17/9/2021,1099965,16680,19002,212,359668,649820,-290152,433465,723617
18/9/2021,1115429,16900,15464,220,354327,650161,-295834,448368,744202
19/9/2021,1131992,17133,16563,233,352015,657354,-305339,457505,762844
20/9/2021,1146310,17348,14318,215,344581,664636,-320055,464326,784381
21/9/2021,1165601,17588,19291,240,339234,672670,-333436,475343,808779
22/9/2021,1184619,17824,19018,236,342552,679533,-336981,487262,824243
23/9/2021,1200249,18060,15630,236,336514,688701,-352187,493488,845675
24/9/2021,1214328,18263,14079,203,330034,690206,-360172,505859,866031
25/9/2021,1230335,18443,16007,180,322628,695443,-372815,516449,889264
26/9/2021,1246846,18627,16511,184,318217,700293,-382076,527926,910002
27/9/2021,1262288,18801,15442,174,313186,705033,-391847,538454,930301
28/9/2021,1275491,18979,13203,178,304413,696571,-392158,559941,952099
29/9/2021,1289934,19141,14443,162,299187,687284,-388097,583509,971606
30/9/2021,1303032,19344,13098,203,292400,674857,-382457,608831,991288
1/10/2021,1314507,19480,11475,136,285510,658946,-373436,636081,1009517
2/10/2021,1323567,19644,9060,164,277205,638985,-361780,664938,1026718
3/10/2021,1332439,19758,8872,114,268666,618884,-350218,693797,1044015
4/10/2021,1341321,19888,8882,130,260228,599953,-339725,721480,1061205
5/10/2021,1348521,20022,7200,134,248422,581446,-333024,747053,1080077
6/10/2021,1355721,20141,7200,119,240173,578494,-338321,757086,1095407
7/10/2021,1362573,20266,6852,125,230456,583819,-353363,758488,1111851
8/10/2021,1370465,20380,7892,114,224041,590603,-366562,759482,1126044
9/10/2021,1377913,20485,7448,105,212207,596627,-384420,760801,1145221
10/10/2021,1383733,20598,5820,113,199001,580936,-381935,782199,1164134
11/10/2021,1389703,20713,5970,115,189339,584242,-394903,784748,1179651
12/10/2021,1394564,20806,4861,93,180143,587663,-407520,786095,1193615
13/10/2021,1400273,20912,5709,106,169832,592075,-422243,787286,1209529
14/10/2021,1407126,20993,6853,81,160199,598128,-437929,788005,1225934
15/10/2021,1413387,21086,6261,93,151006,603378,-452372,788923,1241295
16/10/2021,1418697,21174,5310,88,143118,607019,-463901,790504,1254405
17/10/2021,1423961,21237,5264,63,133964,610880,-476916,791844,1268760
18/10/2021,1429183,21312,5222,75,126076,614891,-488815,792980,1281795
19/10/2021,1434183,21387,5000,75,119601,617950,-498349,794846,1293195
20/10/2021,1440194,21459,6011,72,116555,622152,-505597,796583,1302180
21/10/2021,1446190,21530,5996,71,113680,626536,-512856,798124,1310980
22/10/2021,1452764,21586,6574,56,111387,627852,-516465,803326,1319791
23/10/2021,1458326,21663,5562,77,109728,631999,-522271,804664,1326935
24/10/2021,1465001,21716,6675,53,109227,637307,-528080,805978,1334058
25/10/2021,1471000,21781,5999,65,108362,641918,-533556,807301,1340857
26/10/2021,1476926,21845,5926,64,106397,644791,-538394,810290,1348684
27/10/2021,1484202,21899,7276,54,106235,649989,-543754,812314,1356068
28/10/2021,1492269,21953,8067,54,108482,656353,-547871,813963,1361834
29/10/2021,1500352,22009,8083,56,110593,662211,-551618,816132,1367750
30/10/2021,1508983,22073,8631,64,114355,668574,-554219,818336,1372555
31/10/2021,1518088,22126,9105,53,117762,675628,-557866,820334,1378200
1/11/2021,1527323,22174,9235,48,120149,683084,-562935,822065,1385000
2/11/2021,1536618,22248,9295,74,123157,689564,-566407,824806,1391213
3/11/2021,1548338,22326,11720,78,129563,692337,-562774,833675,1396449
4/11/2021,1559193,22385,10855,59,135173,701402,-566229,835406,1401635
5/11/2021,1571567,22455,12374,70,142314,711765,-569451,837347,1406798
6/11/2021,1583921,22513,12354,58,149680,722307,-572627,839101,1411728
7/11/2021,1596537,22574,12616,61,156282,733561,-577279,840402,1417681
8/11/2021,1609710,22641,13173,67,163453,745594,-582141,841475,1423616
9/11/2021,1623124,22729,13414,88,170272,757595,-587323,842800,1430123
10/11/2021,1636208,22808,13084,79,177803,769346,-591543,844054,1435597
11/11/2021,1649670,22892,13462,84,184585,780830,-596245,845948,1442193
12/11/2021,1664482,22973,14812,81,193401,785298,-591897,856211,1448108
13/11/2021,1678450,23061,13968,88,201436,797335,-595899,858054,1453953
14/11/2021,1691933,23125,13483,64,207667,805497,-597830,863311,1461141
15/11/2021,1706147,23226,14214,101,213777,818405,-604628,864516,1469144
16/11/2021,1723070,23313,16923,87,222631,828760,-606129,870997,1477126
17/11/2021,1739314,23380,16244,67,230264,841064,-610800,874870,1485670
18/11/2021,1756174,23519,16860,139,237947,851062,-613115,881593,1494708
19/11/2021,1772049,23621,15875,102,244624,864864,-620240,883564,1503804
20/11/2021,1787765,23728,15716,107,251040,863700,-612660,900337,1512997
21/11/2021,1804080,23804,16315,76,255666,874776,-619110,905500,1524610
22/11/2021,1821113,23994,17033,190,261730,886843,-625113,910276,1535389
23/11/2021,1839029,24161,17916,167,267295,903558,-636263,911310,1547573
24/11/2021,1858028,24286,18999,125,273982,896481,-622499,937261,1559760
25/11/2021,1878055,24450,20027,164,281354,910717,-629363,942888,1572251
26/11/2021,1899149,24587,21094,137,289302,919306,-630004,955256,1585260
27/11/2021,1924994,24735,25845,148,301722,943335,-641613,956924,1598537
28/11/2021,1945812,24925,20818,190,309414,962251,-652837,958636,1611473
29/11/2021,1967966,25098,22154,173,318123,968144,-650021,974724,1624745
30/11/2021,1990442,25295,22476,197,325763,975799,-650036,989348,1639384
1/12/2021,2013784,25491,23342,196,335138,996241,-661103,992052,1653155
2/12/2021,2035819,25701,22035,210,343676,1004808,-661132,1005310,1666442
3/12/2021,2057794,25901,21975,200,351447,1025434,-673987,1006459,1680446
4/12/2021,2080305,26104,22511,203,357032,1046635,-689603,1007566,1697169
5/12/2021,2103316,26303,23011,199,363803,1067736,-703933,1009277,1713210
6/12/2021,2126772,26526,23456,223,370375,1089839,-719464,1010407,1729871
7/12/2021,2149023,26743,22251,217,376757,1110624,-733867,1011656,1745523
8/12/2021,2172488,26973,23465,230,384493,1109122,-724629,1036393,1761022
9/12/2021,2197101,27230,24613,257,392764,1118892,-726128,1050979,1777107
10/12/2021,2220957,27446,23856,216,399628,1141170,-741542,1052341,1793883
11/12/2021,2246907,27655,25950,209,407669,1165827,-758158,1053425,1811583
12/12/2021,2270440,27883,23533,228,412184,1187837,-775653,1054720,1830373
13/12/2021,2295159,28126,24719,243,416861,1211121,-794260,1055912,1850172
14/12/2021,2319630,28379,24471,253,420228,1230815,-810587,1060436,1871023
15/12/2021,2344590,28663,24960,284,419312,1252499,-833187,1063428,1896615
16/12/2021,2368825,28904,24235,241,422772,1275460,-852688,1064461,1917149
17/12/2021,2393009,29151,24184,247,424796,1268340,-843544,1095518,1939062
18/12/2021,2418237,29400,25228,249,427546,1291674,-864128,1097163,1961291
19/12/2021,2443811,29615,25574,215,429812,1306234,-876422,1107962,1984384
20/12/2021,2467589,29840,23778,225,431545,1327850,-896305,1109899,2006204
21/12/2021,2493502,30091,25913,251,435457,1303321,-867864,1160090,2027954
22/12/2021,2519781,30301,26279,210,439266,1315996,-876730,1173484,2050214
23/12/2021,2545775,30582,25994,281,442178,1330765,-888587,1184428,2073015
24/12/2021,2571419,30817,25644,235,444412,1325341,-880929,1215261,2096190
25/12/2021,2596154,31058,24735,241,446890,1335412,-888522,1229684,2118206
26/12/2021,2620309,31265,24155,207,447614,1340804,-893190,1248240,2141430
27/12/2021,2643918,31469,23609,204,446613,1352835,-906222,1259614,2165836
28/12/2021,2666839,31683,22921,214,445668,1370874,-925206,1264282,2189488
29/12/2021,2688884,31928,22045,245,441732,1354414,-912682,1302542,2215224
30/12/2021,2720415,32168,31531,240,449735,1351603,-901868,1336644,2238512
31/12/2021,2746628,32394,26213,226,451243,1358948,-907705,1355286,2262991
1/1/2022,2770171,32610,23543,216,450325,1362284,-911959,1375277,2287236
2/1/2022,2797070,32831,26899,221,452259,1357541,-905282,1406698,2311980
3/1/2022,2822364,33021,25294,190,453349,1341183,-887834,1448160,2335994
4/1/2022,2845858,33245,23494,224,452625,1331225,-878600,1481388,2359988
5/1/2022,2872764,33474,26906,229,454298,1318239,-863941,1521051,2384992
6/1/2022,2898673,33644,25909,170,454692,1298608,-843916,1566421,2410337
7/1/2022,2924278,33877,25605,233,456456,1292346,-835890,1598055,2433945
8/1/2022,2950317,34117,26039,240,456575,1292154,-835579,1624046,2459625
9/1/2022,2975038,34319,24721,202,455055,1287462,-832407,1653257,2485664
10/1/2022,2998256,34531,23218,212,452269,1203621,-751352,1760104,2511456
11/1/2022,3023382,34787,25126,256,451707,1204624,-752917,1783971,2536888
12/1/2022,3048506,34964,25124,177,452175,1173631,-721456,1839911,2561367
13/1/2022,3074547,35170,26041,206,454032,1156434,-702402,1882943,2585345
14/1/2022,3099519,35341,24972,171,455430,1159944,-704514,1904234,2608748
15/1/2022,3125017,35480,25498,139,458039,1116558,-658519,1972979,2631498
16/1/2022,3149435,35609,24418,129,460422,1114520,-654098,1999306,2653404
17/1/2022,3174869,35788,25434,179,454275,1102602,-648327,2036479,2684806
18/1/2022,3201016,35972,26147,184,454204,1102872,-648668,2062172,2710840
19/1/2022,3225799,36114,24783,142,455486,1077478,-621992,2112207,2734199
20/1/2022,3251756,36266,25957,152,454534,1080546,-626012,2134944,2760956
21/1/2022,3276501,36443,24745,177,453960,1085857,-631897,2154201,2786098
22/1/2022,3300891,36596,24390,153,454880,1089581,-634701,2174714,2809415
23/1/2022,3324150,36719,23259,123,451263,1091559,-640296,2195872,2836168
24/1/2022,3346453,36884,22303,165,447615,1060365,-612750,2249204,2861954
25/1/2022,3370903,37010,24450,126,446499,1004799,-558300,2329094,2887394
26/1/2022,3395680,37165,24777,155,445208,991880,-546672,2366635,2913307
27/1/2022,3420098,37291,24418,126,444934,978169,-533235,2404638,2937873
28/1/2022,3443279,37432,23181,141,444882,979575,-534693,2426272,2960965
29/1/2022,3466803,37547,23524,115,443306,973630,-530324,2455626,2985950
30/1/2022,3487918,37668,21115,121,439291,922605,-483314,2527645,3010959
31/1/2022,3507460,37777,19542,109,432804,920202,-487398,2549481,3036879
1/2/2022,3524454,37872,16994,95,424840,880492,-455652,2606090,3061742
2/2/2022,3537933,37968,13479,96,412820,870079,-457259,2629886,3087145
3/2/2022,3551192,38063,13259,95,401662,841148,-439486,2671981,3111467
4/2/2022,3569072,38147,17880,84,394119,833434,-439315,2697491,3136806
5/2/2022,3587833,38261,18761,114,386703,831623,-444920,2717949,3162869
6/2/2022,3609587,38324,21754,63,383725,829510,-445785,2741753,3187538
7/2/2022,3635510,38424,25923,100,383654,828666,-445012,2768420,3213432
8/2/2022,3669290,38521,33780,97,392692,840950,-448258,2789819,3238077
9/2/2022,3706221,38614,36931,93,405237,790961,-385724,2876646,3262370
10/2/2022,3746358,38688,40137,74,422134,804030,-381896,2903640,3285536
11/2/2022,3787197,38784,40839,96,440648,821696,-381048,2926717,3307765
12/2/2022,3829302,38862,42105,78,458321,840451,-382130,2949989,3332119
13/2/2022,3869974,38946,40672,84,474210,856222,-382012,2974806,3356818
14/2/2022,3915320,39037,45346,91,495131,878282,-383151,2998001,3381152
15/2/2022,3964375,39122,49055,85,521011,900924,-379913,3024329,3404242
16/2/2022,4017935,39188,53560,66,551066,930534,-379468,3048213,3427681
17/2/2022,4073747,39278,55812,90,585739,963444,-377705,3071025,3448730
18/2/2022,4139175,39358,65428,80,631635,1005575,-373940,3094242,3468182
19/2/2022,4203587,39423,64412,65,679068,1046080,-367012,3118084,3485096
20/2/2022,4276012,39501,72425,78,738001,1088011,-350010,3148500,3498510
21/2/2022,4348360,39605,72348,104,797064,1130018,-332954,3178737,3511691
22/2/2022,4434102,39682,85742,77,864953,1188269,-323316,3206151,3529467
23/2/2022,4525611,39773,91509,91,937687,1247044,-309357,3238794,3548151
24/2/2022,4630895,39884,105284,111,1021197,1316153,-294956,3274858,3569814
25/2/2022,4750893,39962,119998,78,1115305,1403236,-287931,3307695,3595626
26/2/2022,4868860,40050,117967,88,1199482,1483686,-284204,3345124,3629328
27/2/2022,4999850,40144,130990,94,1293535,1561714,-268179,3397992,3666171
28/2/2022,5140785,40252,140935,108,1394319,1658500,-264181,3442033,3706214
1/3/2022,5287598,40338,146813,86,1500315,1747293,-246978,3499967,3746945
2/3/2022,5449668,40452,162070,114,1620252,1855345,-235093,3553871,3788964
3/3/2022,5621554,40547,171886,95,1751485,1976394,-224909,3604613,3829522
4/3/2022,5801056,40644,179502,97,1885639,2099886,-214247,3660526,3874773
5/3/2022,5987558,40726,186502,82,2023101,2242738,-219637,3704094,3923731
6/3/2022,6185845,40813,198287,87,2167823,2358491,-190668,3786541,3977209
7/3/2022,6391416,40891,205571,78,2317591,2509989,-192398,3840536,4032934
8/3/2022,6616431,40977,225015,86,2477170,2647014,-169844,3928440,4098284
9/3/2022,6839735,41086,223304,109,2636039,2787335,-151296,4011314,4162610
10/3/2022,7055246,41157,215511,71,2779163,2932622,-153459,4081467,4234926
11/3/2022,7281248,41228,226002,71,2932817,3066694,-133877,4173326,4307203
12/3/2022,7495491,41290,214243,62,3061327,3179062,-117735,4275139,4392874
13/3/2022,7705995,41385,210504,95,3180289,3276931,-96642,4387679,4484321
14/3/2022,7905918,41477,199923,92,3274931,3351353,-76422,4513088,4589510
15/3/2022,8123469,41545,217551,68,3372508,3440670,-68162,4641254,4709416
16/3/2022,8344381,41607,220912,62,3475459,3480172,-4713,4822602,4827315
17/3/2022,8556822,41683,212441,76,3556896,3537035,19861,4978104,4958243
18/3/2022,8750649,41740,193827,57,3609807,3537832,71975,5171077,5099102
19/3/2022,8951837,41817,201188,77,3664162,3592507,71655,5317513,5245858
20/3/2022,9113490,41880,161653,63,3663759,3625460,38299,5446150,5407851
21/3/2022,9264336,41949,150846,69,3642713,3579595,63118,5642792,5579674
22/3/2022,9411898,42014,147562,65,3610777,3523953,86824,5845931,5759107
23/3/2022,9556016,42075,144118,61,3568397,3458543,109854,6055398,5945544
24/3/2022,9691254,42145,135238,70,3505339,3411955,93384,6237154,6143770
25/3/2022,9813323,42196,122069,51,3421856,3341431,80425,6429696,6349271
26/3/2022,9928113,42258,114790,62,3311620,3274604,37016,6611251,6574235
27/3/2022,10030423,42306,102310,48,3190640,3174003,16637,6814114,6797477
28/3/2022,10121413,42358,90990,52,3066115,3125209,-59094,6953846,7012940
29/3/2022,10217618,42413,96205,55,2936315,3021359,-85044,7153846,7238890
30/3/2022,10310977,42454,93359,41,2815445,2999992,-184547,7268531,7453078
31/3/2022,10398869,42493,87892,39,2692835,2837363,-144528,7519013,7663541
1/4/2022,10477642,42526,78773,33,2571691,2828640,-256949,7606476,7863425
2/4/2022,10548886,42563,71244,37,2425380,2792969,-367589,7713354,8080943
3/4/2022,10603674,42600,54788,37,2259256,2773112,-513856,7787962,8301818
4/4/2022,10656288,42642,52614,42,2099424,2769811,-670387,7843835,8514222
5/4/2022,10715681,42681,59393,39,1964993,2525710,-560717,8147290,8708007
6/4/2022,10768684,42712,53003,31,1816816,2448409,-631593,8277563,8909156
7/4/2022,10817975,42733,49291,21,1704464,2380176,-675712,8395066,9070778
8/4/2022,10860120,42768,42145,35,1595749,2361677,-765928,8455675,9221603
9/4/2022,10896698,42794,36578,26,1484774,2356372,-871598,8497532,9369130
10/4/2022,10927030,42813,30332,19,1370995,2351694,-980699,8532523,9513222
11/4/2022,10951802,42830,24772,17,1260531,2354049,-1093518,8554923,9648441
12/4/2022,10976168,42858,24366,28,1162817,2176203,-1013386,8757107,9770493
13/4/2022,11002478,42878,26310,20,1074345,2188606,-1114261,8770994,9885255
14/4/2022,11027065,42901,24587,23,996619,2127537,-1130918,8856627,9987545
15/4/2022,11048405,42924,21340,23,926969,2142437,-1215468,8863044,10078512
16/4/2022,11068032,42934,19627,10,850404,2093724,-1243320,8931374,10174694
17/4/2022,11083608,42944,15576,10,772621,2103818,-1331197,8936846,10268043
18/4/2022,11096333,42957,12725,13,697451,2112312,-1414861,8941064,10355925
19/4/2022,11110632,42975,14299,18,632972,2001963,-1368991,9065694,10434685
20/4/2022,11124688,42982,14056,7,575795,2013472,-1437677,9068234,10505911
21/4/2022,11137409,42991,12721,9,533726,2017491,-1483765,9076927,10560692
22/4/2022,11149209,42998,11800,7,492914,2026946,-1534032,9079265,10613297
23/4/2022,11160168,43004,10959,6,444481,2035670,-1591189,9081494,10672683
24/4/2022,11169488,43013,9320,9,400795,2040400,-1639605,9086075,10725680
25/4/2022,11177332,43021,7844,8,359349,2041551,-1682202,9092760,10774962
26/4/2022,11186214,43029,8882,8,326086,2026960,-1700874,9116225,10817099
27/4/2022,11194643,43034,8429,5,297940,1988477,-1690537,9163132,10853669
28/4/2022,11202139,43037,7496,3,275106,1916799,-1641693,9242303,10883996
29/4/2022,11208531,43038,6392,1,256728,1919965,-1663237,9245528,10908765
30/4/2022,11213909,43041,5378,3,237738,1908613,-1670875,9262255,10933130
1/5/2022,11217822,43042,3913,1,215343,1910414,-1695071,9264366,10959437
2/5/2022,11221109,43044,3287,2,194042,1912609,-1718567,9265456,10984023
3/5/2022,11223959,43044,2850,0,175554,1913634,-1738080,9267281,11005361
4/5/2022,11227209,43047,3250,3,159174,1874826,-1715652,9309336,11024988
5/5/2022,11231740,43049,4531,2,148130,1874271,-1726141,9314420,11040561
6/5/2022,11235759,43055,4019,6,139420,1876467,-1737047,9316237,11053284
7/5/2022,11239279,43055,3520,0,128647,1877699,-1749052,9318525,11067577
8/5/2022,11241667,43056,2388,1,116978,1878020,-1761042,9320591,11081633
9/5/2022,11243956,43057,2289,1,106546,1878734,-1772188,9322165,11094353
10/5/2022,11246961,43058,3005,1,97751,1878969,-1781218,9324934,11106152
11/5/2022,11249862,43060,2901,2,89692,1879279,-1789587,9327523,11117110
12/5/2022,11254018,43063,4156,3,84527,1875991,-1791464,9334964,11126428
13/5/2022,11256360,43063,2342,0,79028,1869268,-1790240,9344029,11134269
14/5/2022,11258354,43065,1994,2,72138,1865697,-1793559,9349592,11143151
15/5/2022,11260032,43065,1678,0,65389,1861927,-1796538,9355040,11151578
16/5/2022,11261663,43067,1631,2,59522,1858833,-1799311,9359763,11159074
17/5/2022,11263541,43071,1878,4,55006,1855613,-1800607,9364857,11165464
18/5/2022,11265467,43072,1926,1,51557,1849101,-1797544,9373294,11170838
19/5/2022,11267272,43073,1805,1,49449,1841318,-1791869,9382881,11174750
20/5/2022,11268941,43075,1669,2,47830,1835834,-1788004,9390032,11178036
21/5/2022,11270474,43075,1533,0,46515,1834298,-1787783,9393101,11180884
22/5/2022,11271862,43075,1388,0,44653,1826741,-1782088,9402046,11184134
23/5/2022,11273102,43076,1240,1,41361,1824118,-1782757,9405908,11188665
24/5/2022,11274494,43076,1392,0,38735,1819015,-1780280,9412403,11192683
25/5/2022,11275908,43078,1414,2,36627,1817968,-1781341,9414862,11196203
26/5/2022,11277249,43078,1341,0,35582,1812086,-1776504,9422085,11198589
27/5/2022,11278552,43078,1303,0,34596,1804024,-1769428,9431450,11200878
28/5/2022,11279724,43078,1172,0,32763,1796733,-1763970,9439913,11203883
29/5/2022,11280660,43078,936,0,30798,1789230,-1758432,9448352,11206784
30/5/2022,11281836,43078,1176,0,27818,1782217,-1754399,9456541,11210940
31/5/2022,11282898,43079,1062,1,26537,1777521,-1750984,9462298,11213282
1/6/2022,11283999,43079,1101,0,25645,1769080,-1743435,9471840,11215275
2/6/2022,11285143,43080,1144,1,25110,1764403,-1739293,9477660,11216953
3/6/2022,11286236,43080,1093,0,24573,1756350,-1731777,9486806,11218583
4/6/2022,11287162,43080,926,0,23621,1747675,-1724054,9496407,11220461
5/6/2022,11287883,43080,721,0,22416,1739848,-1717432,9504955,11222387
6/6/2022,11288730,43081,847,1,21457,1731668,-1710211,9513981,11224192
7/6/2022,11289740,43081,1010,0,20799,1723369,-1702570,9523290,11225860
8/6/2022,11290700,43081,960,0,20226,1715966,-1695740,9531653,11227393
9/6/2022,11291543,43081,843,0,19681,1712464,-1692783,9535998,11228781
10/6/2022,11292554,43082,1011,1,19451,1708874,-1689423,9540598,11230021
11/6/2022,11293301,43083,747,1,18806,1702299,-1683493,9547919,11231412
12/6/2022,11293898,43083,597,0,17990,1697622,-1679632,9553193,11232825
13/6/2022,11294547,43083,649,0,17298,1688941,-1671643,9562523,11234166
14/6/2022,11295447,43083,900,0,16895,1683476,-1666581,9568888,11235469
15/6/2022,11296357,43083,910,0,16633,1679004,-1662371,9574270,11236641
16/6/2022,11297171,43083,814,0,16511,1670983,-1654472,9583105,11237577
17/6/2022,11297931,43083,760,0,16095,1663362,-1647267,9591486,11238753
18/6/2022,11298666,43083,735,0,15768,1658208,-1642440,9597375,11239815
19/6/2022,11299227,43083,561,0,15228,1654514,-1639286,9601630,11240916
20/6/2022,11299774,43083,547,0,14631,1645291,-1630660,9611400,11242060
21/6/2022,11300561,43084,787,1,14324,1640297,-1625973,9617180,11243153
22/6/2022,11301555,43084,994,0,14393,1635634,-1621241,9622837,11244078
23/6/2022,11302333,43084,778,0,14450,1631325,-1616875,9627924,11244799
24/6/2022,11303019,43084,686,0,14289,1622660,-1608371,9637275,11245646
25/6/2022,11303710,43084,691,0,13970,1618112,-1604142,9642514,11246656
26/6/2022,11304296,43084,586,0,13596,1611398,-1597802,9649814,11247616
27/6/2022,11304966,43084,670,0,13423,1605415,-1591992,9656467,11248459
28/6/2022,11305775,43087,809,3,13218,1596716,-1583498,9665972,11249470
29/6/2022,11306592,43087,817,0,13291,1588146,-1574855,9675359,11250214
30/6/2022,11307474,43087,882,0,13576,1583069,-1569493,9681318,11250811
1/7/2022,11308449,43087,975,0,13902,1575699,-1561797,9689663,11251460
2/7/2022,11309217,43087,768,0,13770,1566773,-1553003,9699357,11252360
3/7/2022,11309754,43087,537,0,13397,1557683,-1544286,9708984,11253270
4/7/2022,11310475,43088,721,1,13303,1552224,-1538921,9715163,11254084
5/7/2022,11311516,43089,1041,1,13584,1543505,-1529921,9724922,11254843
6/7/2022,11312476,43089,960,0,13810,1536839,-1523029,9732548,11255577
7/7/2022,11313438,43089,962,0,14211,1529239,-1515028,9741110,11256138
8/7/2022,11314279,43089,841,0,14505,1521325,-1506820,9749865,11256685
9/7/2022,11314999,43089,720,0,14438,1515523,-1501085,9756387,11257472
10/7/2022,11315488,43089,489,0,13933,1507535,-1493602,9764864,11258466
11/7/2022,11316085,43089,597,0,13752,1501975,-1488223,9771021,11259244
12/7/2022,11317005,43090,920,1,13985,1493743,-1479758,9780172,11259930
13/7/2022,11318057,43090,1052,0,14347,1489712,-1475365,9785255,11260620
14/7/2022,11319037,43090,980,0,14741,1482147,-1467406,9793800,11261206
15/7/2022,11320043,43090,1006,0,15077,1477984,-1462907,9798969,11261876
16/7/2022,11320784,43091,741,1,15008,1471365,-1456357,9806328,11262685
17/7/2022,11321568,43091,784,0,14976,1464201,-1449225,9814276,11263501
18/7/2022,11322464,43091,896,0,14990,1461016,-1446026,9818357,11264383
19/7/2022,11323606,43091,1142,0,15157,1456941,-1441784,9823574,11265358
20/7/2022,11324826,43091,1220,0,15609,1449089,-1433480,9832646,11266126
21/7/2022,11326184,43091,1358,0,16430,1445448,-1429018,9837645,11266663
22/7/2022,11327386,43092,1202,1,16910,1442118,-1425208,9842176,11267384
23/7/2022,11328512,43092,1126,0,16996,1433916,-1416920,9851504,11268424
24/7/2022,11329299,43092,787,0,16823,1424931,-1408108,9861276,11269384
25/7/2022,11330241,43092,942,0,16803,1420181,-1403378,9866968,11270346
26/7/2022,11331778,43092,1537,0,17499,1414611,-1397112,9874075,11271187
27/7/2022,11333633,43092,1855,0,18634,1408950,-1390316,9881591,11271907
28/7/2022,11335420,43092,1787,0,19932,1403860,-1383928,9888468,11272396
29/7/2022,11337319,43093,1899,1,21233,1396681,-1375448,9897545,11272993
30/7/2022,11339075,43093,1756,0,22070,1390463,-1368393,9905519,11273912
31/7/2022,11340629,43093,1554,0,22572,1384140,-1361568,9913396,11274964
1/8/2022,11342096,43093,1467,0,23059,1375959,-1352900,9923044,11275944
2/8/2022,11344200,43094,2104,1,24156,1368394,-1344238,9932712,11276950
3/8/2022,11346405,43094,2205,0,25621,1362849,-1337228,9940462,11277690
4/8/2022,11348447,43094,2042,0,26879,1357179,-1330300,9948174,11278474
5/8/2022,11350551,43094,2104,0,28087,1349802,-1321715,9957655,11279370
6/8/2022,11352161,43094,1610,0,28555,1344534,-1315979,9964533,11280512
7/8/2022,11353543,43094,1382,0,28717,1337327,-1308610,9973122,11281732
8/8/2022,11355249,43094,1706,0,29065,1329810,-1300745,9982345,11283090
9/8/2022,11357590,43094,2341,0,30204,1322631,-1292427,9991865,11284292
10/8/2022,11359601,43095,2011,1,31088,1319370,-1288282,9997136,11285418
11/8/2022,11362238,43095,2637,0,32939,1315589,-1282650,10003554,11286204
12/8/2022,11364430,43096,2192,1,34188,1311883,-1277695,10009451,11287146
13/8/2022,11366246,43097,1816,1,34467,1308512,-1274045,10014637,11288682
14/8/2022,11367674,43098,1428,1,34040,1304007,-1269967,10020569,11290536
15/8/2022,11369369,43098,1695,0,33949,1296445,-1262496,10029826,11292322
16/8/2022,11372353,43100,2984,2,35032,1294213,-1259181,10035040,11294221
17/8/2022,11375167,43103,2814,3,36089,1291726,-1255637,10040338,11295975
18/8/2022,11378463,43103,3296,0,37834,1286145,-1248311,10049215,11297526
19/8/2022,11381447,43103,2984,0,39351,1282154,-1242803,10056190,11298993
20/8/2022,11384151,43104,2704,1,39950,1278462,-1238512,10062585,11301097
21/8/2022,11385712,43105,1561,1,39306,1270150,-1230844,10072457,11303301
22/8/2022,11387966,43106,2254,1,39518,1264179,-1224661,10080681,11305342
23/8/2022,11391162,43106,3196,0,40611,1258008,-1217397,10090048,11307445
24/8/2022,11394758,43108,3596,2,42595,1247470,-1204875,10104180,11309055
25/8/2022,11398101,43110,3343,2,44556,1238064,-1193508,10116927,11310435
26/8/2022,11401297,43110,3196,0,46048,1231922,-1185874,10126265,11312139
27/8/2022,11403494,43111,2197,1,45903,1220179,-1174276,10140204,11314480
28/8/2022,11405199,43112,1705,1,45597,1211965,-1166368,10150122,11316490
29/8/2022,11407608,43113,2409,1,45369,1207366,-1161997,10157129,11319126
30/8/2022,11410850,43117,3242,4,46416,1197462,-1151046,10170271,11321317
31/8/2022,11413577,43117,2727,0,47331,1191700,-1144369,10178760,11323129
1/9/2022,11416257,43117,2680,0,48583,1185353,-1136770,10187787,11324557
2/9/2022,11417806,43118,1549,1,48436,1178814,-1130378,10195874,11326252
3/9/2022,11419402,43119,1596,1,47048,1171110,-1124062,10205173,11329235
4/9/2022,11420792,43120,1390,1,45624,1166109,-1120485,10211563,11332048
5/9/2022,11422958,43122,2166,2,44493,1147555,-1103062,10232281,11335343
6/9/2022,11426654,43123,3696,1,45206,1145560,-1100354,10237971,11338325
7/9/2022,11430532,43125,3878,2,46379,1134509,-1088130,10252898,11341028
8/9/2022,11433729,43126,3197,1,48016,1129202,-1081186,10261401,11342587
9/9/2022,11437374,43126,3645,0,49408,1115271,-1065863,10278977,11344840
10/9/2022,11439872,43126,2498,0,48710,1109603,-1060893,10287143,11348036
11/9/2022,11441515,43129,1643,3,46754,1076383,-1029629,10322003,11351632
12/9/2022,11443528,43130,2013,1,45426,1063261,-1017835,10337137,11354972
13/9/2022,11446830,43132,3302,2,45531,1055394,-1009863,10348304,11358167
14/9/2022,11449940,43132,3110,0,46446,1013176,-966730,10393632,11360362
15/9/2022,11452904,43137,2964,5,47700,960954,-913254,10448813,11362067
16/9/2022,11455985,43137,3081,0,48377,904112,-855735,10508736,11364471
17/9/2022,11458464,43138,2479,1,47613,836936,-789323,10578390,11367713
18/9/2022,11460355,43139,1891,1,46777,838187,-791410,10579029,11370439
19/9/2022,11462133,43141,1778,2,45874,839404,-793530,10579588,11373118
20/9/2022,11465311,43142,3178,1,47504,841147,-793643,10581022,11374665
21/9/2022,11467599,43146,2288,4,48193,841765,-793572,10582688,11376260
22/9/2022,11469527,43146,1928,0,48735,842434,-793699,10583947,11377646
23/9/2022,11472072,43146,2545,0,49114,843660,-794546,10585266,11379812
24/9/2022,11473248,43146,1176,0,46594,843906,-797312,10586196,11383508
25/9/2022,11474209,43146,961,0,43677,844202,-800525,10586861,11387386
26/9/2022,11475644,43146,1435,0,41915,844937,-803022,10587561,11390583
27/9/2022,11477229,43147,1585,1,39854,845294,-805440,10588788,11394228
28/9/2022,11478816,43147,1587,0,38944,845852,-806908,10589817,11396725
29/9/2022,11479794,43148,978,1,38278,845729,-807451,10590917,11398368
30/9/2022,11481265,43148,1471,0,37737,846252,-808515,10591865,11400380
1/10/2022,11481936,43149,671,1,35105,846195,-811090,10592592,11403682
2/10/2022,11482426,43149,490,0,32486,846366,-813880,10592911,11406791
3/10/2022,11483222,43149,796,0,30318,846892,-816574,10593181,11409755
4/10/2022,11484243,43151,1021,2,28256,847106,-818850,10593986,11412836
5/10/2022,11485437,43151,1194,0,26973,847442,-820469,10594844,11415313
6/10/2022,11486567,43151,1130,0,26212,848057,-821845,10595359,11417204
7/10/2022,11487269,43152,702,1,25135,848321,-823186,10595796,11418982
8/10/2022,11487951,43153,682,1,22639,848611,-825972,10596187,11422159
9/10/2022,11488322,43153,371,0,20723,848833,-828110,10596336,11424446
10/10/2022,11489367,43153,1045,0,19840,849705,-829865,10596509,11426374
11/10/2022,11490595,43154,1228,1,18522,850305,-831783,10597136,11428919
12/10/2022,11491790,43155,1195,1,18541,851093,-832552,10597542,11430094
13/10/2022,11492860,43155,1070,0,18651,851752,-833101,10597953,11431054
14/10/2022,11493449,43155,589,0,17805,851850,-834045,10598444,11432489
15/10/2022,11494181,43155,732,0,16952,852293,-835341,10598733,11434074
16/10/2022,11494506,43155,325,0,15690,852377,-836687,10598974,11435661
17/10/2022,11495180,43157,674,2,15384,852822,-837438,10599201,11436639
18/10/2022,11495803,43158,623,1,14537,853085,-838548,10599560,11438108
19/10/2022,11497139,43159,1336,1,15202,854055,-838853,10599925,11438778
20/10/2022,11497680,43159,541,0,15254,854297,-839043,10600224,11439267
21/10/2022,11498262,43159,582,0,15040,854523,-839483,10600580,11440063
22/10/2022,11498737,43159,475,0,14494,854721,-840227,10600857,11441084
23/10/2022,11498895,43159,158,0,13458,854771,-841313,10600965,11442278
24/10/2022,11499441,43161,546,2,12872,855191,-842319,10601089,11443408
25/10/2022,11499955,43161,514,0,12686,855259,-842573,10601535,11444108
26/10/2022,11500781,43162,826,1,12829,855684,-842855,10601935,11444790
27/10/2022,11501265,43162,484,0,12943,855844,-842901,10602259,11445160
28/10/2022,11501906,43162,641,0,12539,856198,-843659,10602546,11446205
29/10/2022,11502170,43163,264,1,11574,856171,-844597,10602836,11447433
30/10/2022,11502475,43163,305,0,10685,856316,-845631,10602996,11448627
31/10/2022,11502885,43163,410,0,10025,856510,-846485,10603212,11449697
1/11/2022,11503335,43164,450,1,9885,856573,-846688,10603598,11450286
2/11/2022,11504091,43165,756,1,9909,856984,-847075,10603942,11451017
3/11/2022,11504910,43165,819,0,10404,857559,-847155,10604186,11451341
4/11/2022,11505249,43165,339,0,10069,857703,-847634,10604381,11452015
5/11/2022,11505608,43165,359,0,9805,857852,-848047,10604591,11452638
6/11/2022,11505849,43166,241,1,8709,858020,-849311,10604663,11453974
7/11/2022,11506214,43166,365,0,8534,858267,-849733,10604781,11454514
8/11/2022,11506656,43166,442,0,8394,858482,-850088,10605008,11455096
9/11/2022,11507124,43166,468,0,8387,858643,-850256,10605315,11455571
10/11/2022,11507540,43166,416,0,8645,858906,-850261,10605468,11455729
11/11/2022,11508170,43166,630,0,8729,859335,-850606,10605669,11456275
12/11/2022,11508447,43166,277,0,8492,859414,-850922,10605867,11456789
13/11/2022,11508689,43166,242,0,7908,859586,-851678,10605937,11457615
14/11/2022,11508893,43166,204,0,7628,859724,-852096,10606003,11458099
15/11/2022,11509473,43166,580,0,7567,860151,-852584,10606156,11458740
16/11/2022,11509975,43167,502,1,7804,860509,-852705,10606299,11459004
17/11/2022,11510484,43167,509,0,8009,860857,-852848,10606460,11459308
18/11/2022,11510919,43168,435,1,8033,861118,-853085,10606633,11459718
19/11/2022,11511178,43169,259,1,7842,861263,-853421,10606746,11460167
20/11/2022,11511452,43169,274,0,7361,861382,-854021,10606901,11460922
21/11/2022,11511822,43169,370,0,6912,861639,-854727,10607014,11461741
22/11/2022,11512138,43169,316,0,6889,861803,-854914,10607166,11462080
23/11/2022,11512684,43169,546,0,7076,862170,-855094,10607345,11462439
24/11/2022,11513173,43170,489,1,7323,862321,-854998,10607682,11462680
25/11/2022,11513747,43170,574,0,7533,862726,-855193,10607851,11463044
26/11/2022,11514174,43170,427,0,7518,862945,-855427,10608059,11463486
27/11/2022,11514532,43170,358,0,7408,863250,-855842,10608112,11463954
28/11/2022,11514865,43170,333,0,7325,863482,-856157,10608213,11464370
29/11/2022,11515423,43172,558,2,7251,863909,-856658,10608342,11465000
30/11/2022,11515908,43175,485,3,7458,864245,-856787,10608488,11465275
1/12/2022,11516489,43176,581,1,7799,864736,-856937,10608577,11465514
2/12/2022,11517124,43176,635,0,8231,865226,-856995,10608722,11465717
3/12/2022,11517518,43177,394,1,8044,865512,-857468,10608829,11466297
4/12/2022,11517722,43177,204,0,7747,865623,-857876,10608922,11466798
5/12/2022,11518149,43177,427,0,7665,865984,-858319,10608988,11467307
6/12/2022,11518511,43178,362,1,7591,866194,-858603,10609139,11467742
7/12/2022,11519011,43178,500,0,7833,866576,-858743,10609257,11468000
8/12/2022,11519541,43178,530,0,8089,866993,-858904,10609370,11468274
9/12/2022,11520037,43178,496,0,8215,867386,-859171,10609473,11468644
10/12/2022,11520445,43178,408,0,8307,867694,-859387,10609573,11468960
11/12/2022,11520639,43178,194,0,7955,867840,-859885,10609621,11469506
12/12/2022,11521022,43178,383,0,7849,868167,-860318,10609677,11469995
13/12/2022,11521388,43179,366,1,7640,868426,-860786,10609783,11470569
14/12/2022,11521708,43179,320,0,7534,868617,-861083,10609912,11470995
15/12/2022,11522098,43179,390,0,7566,868884,-861318,10610035,11471353
16/12/2022,11522431,43179,333,0,7566,869130,-861564,10610122,11471686
17/12/2022,11522750,43179,319,0,7327,869354,-862027,10610217,11472244
18/12/2022,11522927,43179,177,0,7019,869482,-862463,10610266,11472729
19/12/2022,11523163,43180,236,1,6673,869693,-863020,10610290,11473310
20/12/2022,11523367,43180,204,0,6243,869838,-863595,10610349,11473944
21/12/2022,11523567,43181,200,1,6048,869905,-863857,10610481,11474338
22/12/2022,11523781,43182,214,1,6058,870026,-863968,10610573,11474541
23/12/2022,11524095,43184,314,2,5944,870219,-864275,10610692,11474967
24/12/2022,11524202,43184,107,0,5691,870255,-864564,10610763,11475327
25/12/2022,11524273,43184,71,0,5262,870285,-865023,10610804,11475827
26/12/2022,11524436,43184,163,0,4895,870421,-865526,10610831,11476357
27/12/2022,11524647,43184,211,0,4610,870546,-865936,10610917,11476853
28/12/2022,11524779,43184,132,0,4334,870536,-866202,10611059,11477261
29/12/2022,11525013,43184,234,0,4374,870715,-866341,10611114,11477455
30/12/2022,11525145,43186,132,2,4121,870776,-866655,10611183,11477838
31/12/2022,11525231,43186,86,0,3843,870770,-866927,10611275,11478202
1/1/2023,11525284,43186,53,0,3576,870776,-867200,10611322,11478522
2/1/2023,11525337,43186,53,0,3239,870826,-867587,10611325,11478912
3/1/2023,11525408,43186,71,0,2977,870884,-867907,10611338,11479245
4/1/2023,11525491,43186,83,0,2741,870916,-868175,10611389,11479564
5/1/2023,11525571,43186,80,0,2644,870962,-868318,10611423,11479741
6/1/2023,11525647,43186,76,0,2484,871003,-868519,10611458,11479977
7/1/2023,11525711,43186,64,0,2344,871031,-868687,10611494,11480181
8/1/2023,11525763,43186,52,0,2196,871069,-868873,10611508,11480381
9/1/2023,11525834,43186,71,0,2053,871137,-869084,10611511,11480595
10/1/2023,11525911,43186,77,0,1816,871178,-869362,10611547,11480909
11/1/2023,11525946,43186,35,0,1744,871188,-869444,10611572,11481016
12/1/2023,11526034,43186,88,0,1761,871198,-869437,10611650,11481087
13/1/2023,11526089,43186,55,0,1653,870854,-869201,10612049,11481250
14/1/2023,11526118,43186,29,0,1471,870843,-869372,10612089,11481461
15/1/2023,11526140,43186,22,0,1361,870849,-869488,10612105,11481593
16/1/2023,11526167,43186,27,0,1154,870864,-869710,10612117,11481827
17/1/2023,11526213,43186,46,0,1068,870881,-869813,10612146,11481959
18/1/2023,11526254,43186,41,0,1023,870848,-869825,10612220,11482045
19/1/2023,11526284,43186,30,0,1000,870737,-869737,10612361,11482098
20/1/2023,11526301,43186,17,0,964,870723,-869759,10612392,11482151
21/1/2023,11526318,43186,17,0,910,870732,-869822,10612400,11482222
22/1/2023,11526329,43186,11,0,838,870734,-869896,10612409,11482305
23/1/2023,11526332,43186,3,0,761,870736,-869975,10612410,11482385
24/1/2023,11526339,43186,7,0,692,870740,-870048,10612413,11482461
25/1/2023,11526348,43186,9,0,637,870748,-870111,10612414,11482525
26/1/2023,11526365,43186,17,0,602,870753,-870151,10612426,11482577
27/1/2023,11526377,43186,12,0,543,870758,-870215,10612433,11482648
28/1/2023,11526395,43186,18,0,484,870771,-870287,10612438,11482725
29/1/2023,11526408,43186,13,0,462,870778,-870316,10612444,11482760
30/1/2023,11526461,43186,53,0,427,870828,-870401,10612447,11482848
31/1/2023,11526497,43186,36,0,408,870849,-870441,10612462,11482903
1/2/2023,11526508,43186,11,0,390,870843,-870453,10612479,11482932
2/2/2023,11526522,43186,14,0,382,870142,-869760,10613194,11482954
3/2/2023,11526543,43186,21,0,376,870158,-869782,10613199,11482981
4/2/2023,11526559,43186,16,0,346,868792,-868446,10614581,11483027
5/2/2023,11526566,43186,7,0,312,868794,-868482,10614586,11483068
6/2/2023,11526577,43186,11,0,293,868800,-868507,10614591,11483098
7/2/2023,11526591,43186,14,0,290,868812,-868522,10614593,11483115
8/2/2023,11526610,43186,19,0,292,868826,-868534,10614598,11483132
9/2/2023,11526627,43186,17,0,298,868797,-868499,10614644,11483143
10/2/2023,11526640,43186,13,0,308,868800,-868492,10614654,11483146
11/2/2023,11526651,43186,11,0,312,868805,-868493,10614660,11483153
12/2/2023,11526692,43186,41,0,344,868835,-868491,10614671,11483162
13/2/2023,11526704,43186,12,0,339,868839,-868500,10614679,11483179
14/2/2023,11526754,43186,50,0,377,868858,-868481,10614710,11483191
15/2/2023,11526773,43186,19,0,378,868875,-868497,10614712,11483209
16/2/2023,11526786,43186,13,0,378,868884,-868506,10614716,11483222
17/2/2023,11526799,43186,13,0,338,868897,-868559,10614716,11483275
18/2/2023,11526806,43186,7,0,309,868899,-868590,10614721,11483311
19/2/2023,11526810,43186,4,0,302,868902,-868600,10614722,11483322
20/2/2023,11526825,43186,15,0,303,868917,-868614,10614722,11483336
21/2/2023,11526834,43186,9,0,291,868920,-868629,10614728,11483357
22/2/2023,11526858,43186,24,0,299,868937,-868638,10614735,11483373
23/2/2023,11526870,43186,12,0,304,868944,-868640,10614740,11483380
24/2/2023,11526881,43186,11,0,304,868940,-868636,10614755,11483391
25/2/2023,11526891,43186,10,0,300,868946,-868646,10614759,11483405
26/2/2023,11526901,43186,10,0,291,868955,-868664,10614760,11483424
27/2/2023,11526905,43186,4,0,278,868956,-868678,10614763,11483441
28/2/2023,11526917,43186,12,0,277,868962,-868685,10614769,11483454
1/3/2023,11526926,43186,9,0,275,868963,-868688,10614777,11483465
2/3/2023,11526937,43186,11,0,245,868968,-868723,10614783,11483506
3/3/2023,11526950,43186,13,0,246,868976,-868730,10614788,11483518
4/3/2023,11526962,43186,12,0,208,868988,-868780,10614788,11483568
5/3/2023,11526966,43186,4,0,193,868990,-868797,10614790,11483587
6/3/2023,11526966,43186,0,0,180,868990,-868810,10614790,11483600
7/3/2023,11526986,43186,20,0,187,868998,-868811,10614802,11483613
8/3/2023,11526994,43186,8,0,188,869001,-868813,10614807,11483620
9/3/2023,11527012,43186,18,0,202,869017,-868815,10614809,11483624
10/3/2023,11527026,43186,14,0,201,869025,-868824,10614815,11483639
11/3/2023,11527033,43186,7,0,199,869030,-868831,10614817,11483648
12/3/2023,11527037,43186,4,0,179,869033,-868854,10614818,11483672
13/3/2023,11527046,43186,9,0,176,869041,-868865,10614819,11483684
14/3/2023,11527054,43186,8,0,173,869045,-868872,10614823,11483695
15/3/2023,11527079,43186,25,0,188,869064,-868876,10614829,11483705
16/3/2023,11527099,43186,20,0,198,869078,-868880,10614835,11483715
17/3/2023,11527110,43186,11,0,205,869083,-868878,10614841,11483719
18/3/2023,11527116,43186,6,0,199,869083,-868884,10614847,11483731
19/3/2023,11527139,43186,23,0,213,869096,-868883,10614857,11483740
20/3/2023,11527146,43186,7,0,209,869103,-868894,10614857,11483751
21/3/2023,11527157,43186,11,0,207,869110,-868903,10614861,11483764
22/3/2023,11527175,43186,18,0,213,869114,-868901,10614875,11483776
23/3/2023,11527187,43186,12,0,221,869115,-868894,10614886,11483780
24/3/2023,11527195,43186,8,0,229,869113,-868884,10614896,11483780
25/3/2023,11527203,43186,8,0,217,869118,-868901,10614899,11483800
26/3/2023,11527210,43186,7,0,216,869125,-868909,10614899,11483808
27/3/2023,11527220,43186,10,0,208,869091,-868883,10614943,11483826
28/3/2023,11527236,43186,16,0,210,869104,-868894,10614946,11483840
29/3/2023,11527255,43186,19,0,222,869118,-868896,10614951,11483847
30/3/2023,11527285,43186,30,0,248,869143,-868895,10614956,11483851
31/3/2023,11527301,43186,16,0,255,869149,-868894,10614966,11483860
1/4/2023,11527316,43186,15,0,262,869153,-868891,10614977,11483868
2/4/2023,11527326,43186,10,0,247,869152,-868905,10614988,11483893
3/4/2023,11527366,43186,40,0,267,869192,-868925,10614988,11483913
4/4/2023,11527403,43186,37,0,293,869226,-868933,10614991,11483924
5/4/2023,11527454,43186,51,0,338,869254,-868916,10615014,11483930
6/4/2023,11527497,43186,43,0,358,869283,-868925,10615028,11483953
7/4/2023,11527579,43186,82,0,433,869361,-868928,10615032,11483960
8/4/2023,11527701,43186,122,0,544,869462,-868918,10615053,11483971
9/4/2023,11527745,43186,44,0,570,869480,-868910,10615079,11483989
10/4/2023,11527859,43186,114,0,672,869575,-868903,10615098,11484001
11/4/2023,11528042,43186,183,0,847,869722,-868875,10615134,11484009
12/4/2023,11528303,43186,261,0,1100,869937,-868837,10615180,11484017
13/4/2023,11528800,43186,497,0,1590,870397,-868807,10615217,11484024
14/4/2023,11529581,43186,781,0,2361,871074,-868713,10615321,11484034
15/4/2023,11530356,43186,775,0,3120,871827,-868707,10615343,11484050
16/4/2023,11531072,43186,716,0,3817,872493,-868676,10615393,11484069
17/4/2023,11532103,43186,1031,0,4818,873522,-868704,10615395,11484099
18/4/2023,11533625,43186,1522,0,6324,874906,-868582,10615533,11484115
19/4/2023,11535787,43186,2162,0,8471,876859,-868388,10615742,11484130
20/4/2023,11538248,43186,2461,0,10922,879075,-868153,10615987,11484140
21/4/2023,11540722,43186,2474,0,13356,881343,-867987,10616193,11484180
22/4/2023,11543059,43187,2337,1,15655,883147,-867492,10616725,11484217
23/4/2023,11544777,43187,1718,0,17323,884498,-867175,10617092,11484267
24/4/2023,11546685,43187,1908,0,19188,886179,-866991,10617319,11484310
25/4/2023,11549186,43188,2501,1,21606,887860,-866254,10618138,11484392
26/4/2023,11551917,43188,2731,0,24216,889978,-865762,10618751,11484513
27/4/2023,11554875,43188,2958,0,27130,891874,-864744,10619813,11484557
28/4/2023,11557969,43188,3094,0,30110,894205,-864095,10620576,11484671
29/4/2023,11559862,43188,1893,0,31820,895201,-863381,10621473,11484854
30/4/2023,11561848,43191,1986,3,33542,896530,-862988,10622127,11485115
1/5/2023,11563091,43191,1243,0,34291,897156,-862865,10622744,11485609
2/5/2023,11564293,43195,1202,4,34708,897607,-862899,10623491,11486390
3/5/2023,11565495,43195,1202,0,35139,898268,-863129,10624032,11487161
4/5/2023,11567728,43195,2233,0,36656,899692,-863036,10624841,11487877
5/5/2023,11571127,43196,3399,1,39023,902093,-863070,10625838,11488908
6/5/2023,11573931,43196,2804,0,40306,904211,-863905,10626524,11490429
7/5/2023,11575883,43196,1952,0,40096,905425,-865329,10627262,11492591
8/5/2023,11577938,43197,2055,1,39689,907005,-867316,10627736,11495052
9/5/2023,11580060,43197,2122,0,39338,908185,-868847,10628678,11497525
10/5/2023,11582567,43198,2507,1,39507,910034,-870527,10629335,11499862
11/5/2023,11585390,43200,2823,2,40611,911930,-871319,10630260,11501579
12/5/2023,11587829,43201,2439,1,41143,913404,-872261,10631224,11503485
13/5/2023,11589567,43201,1738,0,40381,914317,-873936,10632049,11505985
14/5/2023,11590617,43201,1050,0,38700,915082,-876382,10632334,11508716
15/5/2023,11592604,43201,1987,0,37729,916827,-879098,10632576,11511674
16/5/2023,11594619,43201,2015,0,36650,918567,-881917,10632851,11514768
17/5/2023,11596662,43201,2043,0,36800,919757,-882957,10633704,11516661
18/5/2023,11598589,43201,1927,0,36741,921215,-884474,10634173,11518647
19/5/2023,11600569,43201,1980,0,37478,922753,-885275,10634615,11519890
20/5/2023,11601759,43202,1190,1,37465,923640,-886175,10634917,11521092
21/5/2023,11602738,43203,979,1,37242,924470,-887228,10635065,11522293
22/5/2023,11603960,43204,1222,1,36231,925387,-889156,10635369,11524525
23/5/2023,11605398,43205,1438,1,34270,926281,-892011,10635912,11527923
24/5/2023,11606479,43205,1081,0,32548,926840,-894292,10636434,11530726
25/5/2023,11607654,43206,1175,1,31770,927575,-895805,10636873,11532678
26/5/2023,11608697,43206,1043,0,30759,928353,-897594,10637138,11534732
27/5/2023,11609537,43206,840,0,29477,928995,-899518,10637336,11536854
28/5/2023,11609878,43206,341,0,27311,929149,-901838,10637523,11539361
29/5/2023,11610724,43206,846,0,25334,929864,-904530,10637654,11542184
30/5/2023,11611376,43206,652,0,23547,930243,-906696,10637927,11544623
31/5/2023,11612608,43206,1232,0,23041,931234,-908193,10638168,11546361
1/6/2023,11613559,43206,951,0,22942,931983,-909041,10638370,11547411
2/6/2023,11614303,43206,744,0,21699,932548,-910849,10638549,11549398
3/6/2023,11614583,43206,280,0,19964,932614,-912650,10638763,11551413
4/6/2023,11615051,43206,468,0,18389,933034,-914645,10638811,11553456
5/6/2023,11615377,43206,326,0,16788,933297,-916509,10638874,11555383
6/6/2023,11616127,43206,750,0,15558,933943,-918385,10638978,11557363
7/6/2023,11616702,43206,575,0,14943,934421,-919478,10639075,11558553
8/6/2023,11617220,43206,518,0,14482,934834,-920352,10639180,11559532
9/6/2023,11617497,43206,277,0,13537,935021,-921484,10639270,11560754
10/6/2023,11617699,43206,202,0,12301,935154,-922853,10639339,11562192
11/6/2023,11617814,43206,115,0,11335,935200,-923865,10639408,11563273
12/6/2023,11617985,43206,171,0,10331,935332,-925001,10639447,11564448
13/6/2023,11618184,43206,199,0,9487,935477,-925990,10639501,11565491
14/6/2023,11618422,43206,238,0,8885,935575,-926690,10639641,11566331
15/6/2023,11618751,43206,329,0,8873,935877,-927004,10639668,11566672
16/6/2023,11619016,43206,265,0,8292,936092,-927800,10639718,11567518
17/6/2023,11619267,43206,251,0,7891,936288,-928397,10639773,11568170
18/6/2023,11619322,43206,55,0,6714,936311,-929597,10639805,11569402
19/6/2023,11619451,43206,129,0,5892,936426,-930534,10639819,11570353
20/6/2023,11619588,43206,137,0,5285,936525,-931240,10639857,11571097
21/6/2023,11619703,43206,115,0,5120,936617,-931497,10639880,11571377
22/6/2023,11619843,43206,140,0,4792,936713,-931921,10639924,11571845
23/6/2023,11619990,43206,147,0,4613,936822,-932209,10639962,11572171
24/6/2023,11620047,43206,57,0,3920,936871,-932951,10639970,11572921
25/6/2023,11620076,43206,29,0,3374,936897,-933523,10639973,11573496
26/6/2023,11620189,43206,113,0,2969,936997,-934028,10639986,11574014
27/6/2023,11620264,43206,75,0,2767,937035,-934268,10640023,11574291
28/6/2023,11620389,43206,125,0,2690,937134,-934444,10640049,11574493
29/6/2023,11620482,43206,93,0,2668,937211,-934543,10640065,11574608
30/6/2023,11620561,43206,79,0,2576,937280,-934704,10640075,11574779
1/7/2023,11620596,43206,35,0,2412,937296,-934884,10640094,11574978
2/7/2023,11620623,43206,27,0,2201,937315,-935114,10640102,11575216
3/7/2023,11620708,43206,85,0,1957,937398,-935441,10640104,11575545
4/7/2023,11620769,43206,61,0,1753,937441,-935688,10640122,11575810
5/7/2023,11620833,43206,64,0,1566,937489,-935923,10640138,11576061
6/7/2023,11620890,43206,57,0,1568,937535,-935967,10640149,11576116
7/7/2023,11620947,43206,57,0,1496,937577,-936081,10640164,11576245
8/7/2023,11621033,43206,86,0,1445,937648,-936203,10640179,11576382
9/7/2023,11621057,43206,24,0,1354,937657,-936303,10640194,11576497
10/7/2023,11621096,43206,39,0,1253,937693,-936440,10640197,11576637
11/7/2023,11621143,43206,47,0,1153,937735,-936582,10640202,11576784
12/7/2023,11621192,43206,49,0,1145,937771,-936626,10640215,11576841
13/7/2023,11621228,43206,36,0,1152,937796,-936644,10640226,11576870
14/7/2023,11621288,43206,60,0,1099,937851,-936752,10640231,11576983
15/7/2023,11621320,43206,32,0,1056,937876,-936820,10640238,11577058
16/7/2023,11621347,43206,27,0,958,937898,-936940,10640243,11577183
17/7/2023,11621397,43206,50,0,915,937937,-937022,10640254,11577276
18/7/2023,11621426,43206,29,0,865,937955,-937090,10640265,11577355
19/7/2023,11621489,43206,63,0,893,938012,-937119,10640271,11577390
20/7/2023,11621522,43206,33,0,899,938033,-937134,10640283,11577417
21/7/2023,11621558,43206,36,0,850,938063,-937213,10640289,11577502
22/7/2023,11621599,43206,41,0,830,938094,-937264,10640299,11577563
23/7/2023,11621626,43206,27,0,793,938118,-937325,10640302,11577627
24/7/2023,11621681,43206,55,0,791,938171,-937380,10640304,11577684
25/7/2023,11621708,43206,27,0,761,938194,-937433,10640308,11577741
26/7/2023,11621728,43206,20,0,695,938211,-937516,10640311,11577827
27/7/2023,11621752,43206,24,0,695,938228,-937533,10640318,11577851
28/7/2023,11621789,43206,37,0,693,938261,-937568,10640322,11577890
29/7/2023,11621798,43206,9,0,655,938270,-937615,10640322,11577937
30/7/2023,11621812,43206,14,0,620,938276,-937656,10640330,11577986
31/7/2023,11621840,43206,28,0,612,938303,-937691,10640331,11578022
1/8/2023,11621883,43206,43,0,595,938342,-937747,10640335,11578082
2/8/2023,11621909,43206,26,0,589,938358,-937769,10640345,11578114
3/8/2023,11621934,43206,25,0,587,938381,-937794,10640347,11578141
4/8/2023,11621965,43206,31,0,568,938409,-937841,10640350,11578191
5/8/2023,11621978,43206,13,0,552,938415,-937863,10640357,11578220
6/8/2023,11621997,43206,19,0,508,938433,-937925,10640358,11578283
7/8/2023,11622021,43206,24,0,499,938456,-937957,10640359,11578316
8/8/2023,11622053,43206,32,0,495,938480,-937985,10640367,11578352
9/8/2023,11622092,43206,39,0,493,938514,-938021,10640372,11578393
10/8/2023,11622119,43206,27,0,493,938535,-938042,10640378,11578420
11/8/2023,11622178,43206,59,0,497,938591,-938094,10640381,11578475
12/8/2023,11622204,43206,26,0,496,938612,-938116,10640386,11578502
13/8/2023,11622218,43206,14,0,490,938625,-938135,10640387,11578522
14/8/2023,11622238,43206,20,0,486,938644,-938158,10640388,11578546
15/8/2023,11622276,43206,38,0,487,938678,-938191,10640392,11578583
16/8/2023,11622327,43206,51,0,529,938726,-938197,10640395,11578592
17/8/2023,11622366,43206,39,0,554,938760,-938206,10640400,11578606
18/8/2023,11622383,43206,17,0,543,938770,-938227,10640407,11578634
19/8/2023,11622404,43206,21,0,521,938776,-938255,10640422,11578677
20/8/2023,11622419,43206,15,0,510,938786,-938276,10640427,11578703
21/8/2023,11622463,43206,44,0,529,938829,-938300,10640428,11578728
22/8/2023,11622514,43206,51,0,549,938869,-938320,10640439,11578759
23/8/2023,11622564,43206,50,0,586,938915,-938329,10640443,11578772
24/8/2023,11622587,43206,23,0,590,938929,-938339,10640452,11578791
25/8/2023,11622660,43206,73,0,639,938993,-938354,10640461,11578815
26/8/2023,11622683,43206,23,0,630,939004,-938374,10640473,11578847
27/8/2023,11622697,43206,14,0,605,939014,-938409,10640477,11578886
28/8/2023,11622730,43206,33,0,611,939045,-938434,10640479,11578913
29/8/2023,11622769,43206,39,0,591,939066,-938475,10640497,11578972
30/8/2023,11622820,43206,51,0,616,939098,-938482,10640516,11578998
31/8/2023,11622858,43206,38,0,640,939118,-938478,10640534,11579012
1/9/2023,11622900,43206,42,0,662,939147,-938485,10640547,11579032
2/9/2023,11622912,43206,12,0,636,939155,-938519,10640551,11579070
3/9/2023,11622924,43206,12,0,597,939163,-938566,10640555,11579121
4/9/2023,11622943,43206,19,0,577,939179,-938602,10640558,11579160
5/9/2023,11622975,43206,32,0,592,939207,-938615,10640562,11579177
6/9/2023,11623024,43206,49,0,620,939223,-938603,10640595,11579198
7/9/2023,11623056,43206,32,0,637,939238,-938601,10640612,11579213
8/9/2023,11623119,43206,63,0,656,939294,-938638,10640619,11579257
9/9/2023,11623182,43206,63,0,668,939352,-938684,10640624,11579308
10/9/2023,11623187,43206,5,0,623,939345,-938722,10640636,11579358
11/9/2023,11623216,43206,29,0,629,939370,-938741,10640640,11579381
12/9/2023,11623259,43206,43,0,599,939410,-938811,10640643,11579454
13/9/2023,11623288,43206,29,0,605,939419,-938814,10640663,11579477
14/9/2023,11623318,43206,30,0,621,939449,-938828,10640663,11579491
15/9/2023,11623357,43206,39,0,627,939477,-938850,10640674,11579524
16/9/2023,11623372,43206,15,0,603,939481,-938878,10640685,11579563
17/9/2023,11623393,43206,21,0,573,939487,-938914,10640700,11579614
18/9/2023,11623420,43206,27,0,562,939510,-938948,10640704,11579652
19/9/2023,11623461,43206,41,0,561,939544,-938983,10640711,11579694
20/9/2023,11623485,43206,24,0,573,939553,-938980,10640726,11579706
21/9/2023,11623513,43206,28,0,589,939571,-938982,10640736,11579718
22/9/2023,11623560,43206,47,0,617,939613,-938996,10640741,11579737
23/9/2023,11623571,43206,11,0,596,939609,-939013,10640756,11579769
24/9/2023,11623577,43206,6,0,553,939611,-939058,10640760,11579818
25/9/2023,11623605,43206,28,0,549,939634,-939085,10640765,11579850
26/9/2023,11623631,43206,26,0,512,939658,-939146,10640767,11579913
27/9/2023,11623649,43206,18,0,467,939666,-939199,10640777,11579976
28/9/2023,11623667,43206,18,0,480,939678,-939198,10640783,11579981
29/9/2023,11623688,43206,21,0,472,939695,-939223,10640787,11580010
30/9/2023,11623698,43206,10,0,439,939683,-939244,10640809,11580053
1/10/2023,11623707,43206,9,0,419,939686,-939267,10640815,11580082
2/10/2023,11623724,43206,17,0,406,939698,-939292,10640820,11580112
3/10/2023,11623747,43206,23,0,390,939713,-939323,10640828,11580151
4/10/2023,11623774,43206,27,0,402,939724,-939322,10640844,11580166
5/10/2023,11623802,43206,28,0,409,939745,-939336,10640851,11580187
6/10/2023,11623834,43206,32,0,414,939771,-939357,10640857,11580214
7/10/2023,11623845,43206,11,0,384,939777,-939393,10640862,11580255
8/10/2023,11623847,43206,2,0,362,939775,-939413,10640866,11580279
9/10/2023,11623858,43206,11,0,345,939778,-939433,10640874,11580307
10/10/2023,11623894,43206,36,0,334,939813,-939479,10640875,11580354
11/10/2023,11623911,43206,17,0,340,939815,-939475,10640890,11580365
12/10/2023,11623938,43206,27,0,361,939836,-939475,10640896,11580371
13/10/2023,11623976,43206,38,0,371,939869,-939498,10640901,11580399
14/10/2023,11623987,43206,11,0,356,939879,-939523,10640902,11580425
15/10/2023,11624000,43206,13,0,351,939877,-939526,10640917,11580443
16/10/2023,11624025,43206,25,0,358,939902,-939544,10640917,11580461
17/10/2023,11624041,43206,16,0,353,939910,-939557,10640925,11580482
18/10/2023,11624054,43206,13,0,356,939907,-939551,10640941,11580492
19/10/2023,11624065,43206,11,0,358,939906,-939548,10640953,11580501
20/10/2023,11624072,43206,7,0,348,939901,-939553,10640965,11580518
21/10/2023,11624080,43206,8,0,333,939903,-939570,10640971,11580541
22/10/2023,11624080,43206,0,0,306,939903,-939597,10640971,11580568
23/10/2023,11624084,43206,4,0,282,939907,-939625,10640971,11580596
24/10/2023,11624089,43206,5,0,255,939912,-939657,10640971,11580628
25/10/2023,11624095,43206,6,0,250,939918,-939668,10640971,11580639
26/10/2023,11624096,43206,1,0,249,939919,-939670,10640971,11580641
27/10/2023,11624100,43206,4,0,242,939923,-939681,10640971,11580652
28/10/2023,11624100,43206,0,0,206,939923,-939717,10640971,11580688
29/10/2023,11624100,43206,0,0,189,939923,-939734,10640971,11580705
30/10/2023,11624105,43206,5,0,167,939928,-939761,10640971,11580732
31/10/2023,11624114,43206,9,0,138,939937,-939799,10640971,11580770
1/11/2023,11624114,43206,0,0,127,939937,-939810,10640971,11580781
2/11/2023,11624114,43206,0,0,114,939937,-939823,10640971,11580794
3/11/2023,11624114,43206,0,0,89,939937,-939848,10640971,11580819
4/11/2023,11624114,43206,0,0,73,939937,-939864,10640971,11580835
5/11/2023,11624114,43206,0,0,60,939937,-939877,10640971,11580848
6/11/2023,11624114,43206,0,0,49,939937,-939888,10640971,11580859
7/11/2023,11624114,43206,0,0,42,939937,-939895,10640971,11580866
8/11/2023,11624114,43206,0,0,34,939937,-939903,10640971,11580874
9/11/2023,11624114,43206,0,0,34,939937,-939903,10640971,11580874
10/11/2023,11624114,43206,0,0,30,939937,-939907,10640971,11580878
11/11/2023,11624114,43206,0,0,25,939937,-939912,10640971,11580883
12/11/2023,11624114,43206,0,0,19,939937,-939918,10640971,11580889
13/11/2023,11624114,43206,0,0,18,939937,-939919,10640971,11580890
14/11/2023,11624114,43206,0,0,14,939937,-939923,10640971,11580894
15/11/2023,11624114,43206,0,0,14,939937,-939923,10640971,11580894
16/11/2023,11624114,43206,0,0,14,939937,-939923,10640971,11580894
17/11/2023,11624114,43206,0,0,9,939937,-939928,10640971,11580899
18/11/2023,11624114,43206,0,0,0,939937,-939937,10640971,11580908
19/11/2023,11624114,43206,0,0,0,939937,-939937,10640971,11580908
20/11/2023,11624114,43206,0,0,0,939937,-939937,10640971,11580908
21/11/2023,11624114,43206,0,0,0,939937,-939937,10640971,11580908
22/11/2023,11624114,43206,0,0,0,939937,-939937,10640971,11580908
23/11/2023,11624114,43206,0,0,0,939937,-939937,10640971,11580908
24/11/2023,11624114,43206,0,0,0,939937,-939937,10640971,11580908
25/11/2023,11624114,43206,0,0,0,939937,-939937,10640971,11580908
26/11/2023,11624114,43206,0,0,0,939937,-939937,10640971,11580908
27/11/2023,11624114,43206,0,0,0,939937,-939937,10640971,11580908
28/11/2023,11624114,43206,0,0,0,939937,-939937,10640971,11580908
29/11/2023,11624114,43206,0,0,0,939937,-939937,10640971,11580908
30/11/2023,11624114,43206,0,0,0,939937,-939937,10640971,11580908
1/12/2023,11624114,43206,0,0,0,939937,-939937,10640971,11580908
2/12/2023,11624114,43206,0,0,0,939937,-939937,10640971,11580908
3/12/2023,11624114,43206,0,0,0,939937,-939937,10640971,11580908
4/12/2023,11624114,43206,0,0,0,939937,-939937,10640971,11580908
5/12/2023,11624114,43206,0,0,0,939937,-939937,10640971,11580908
6/12/2023,11624114,43206,0,0,0,939937,-939937,10640971,11580908
7/12/2023,11624114,43206,0,0,0,939937,-939937,10640971,11580908
8/12/2023,11624114,43206,0,0,0,939937,-939937,10640971,11580908
9/12/2023,11624114,43206,0,0,0,939937,-939937,10640971,11580908
10/12/2023,11624114,43206,0,0,0,939937,-939937,10640971,11580908
11/12/2023,11624114,43206,0,0,0,939937,-939937,10640971,11580908
12/12/2023,11624114,43206,0,0,0,939937,-939937,10640971,11580908
13/12/2023,11624114,43206,0,0,0,939937,-939937,10640971,11580908
14/12/2023,11624114,43206,0,0,0,939937,-939937,10640971,11580908
15/12/2023,11624114,43206,0,0,0,939937,-939937,10640971,11580908
